parameters,simulationID,total,total_traced,total_not_traced,handled,handled_no_sla,dropped,avg_queue_time,avg_call_time,avg_drop_time,no_sla_ratio,drop_ratio
03-0.5-480-30-10-03-10-15-05,1,241,227,14,139,85,88,11.704347826086957,10.129496402877697,10.977272727272727,0.6115107913669064,0.3876651982378855
03-0.5-480-30-10-03-10-15-05,2,232,222,10,142,77,80,10.666666666666666,9.82394366197183,10.9,0.5422535211267606,0.36036036036036034
03-0.5-480-30-10-03-10-15-05,3,219,211,8,144,75,67,10.771028037383177,9.847222222222221,10.82089552238806,0.5208333333333334,0.3175355450236967
03-0.5-480-30-10-03-10-15-05,4,237,228,9,149,86,79,10.74891774891775,9.563758389261745,10.354430379746836,0.5771812080536913,0.34649122807017546
03-0.5-480-30-10-03-10-15-05,5,266,258,8,142,106,116,11.789272030651341,9.887323943661972,11.14655172413793,0.7464788732394366,0.4496124031007752
03-0.5-480-30-10-03-10-15-05,6,226,221,5,143,101,78,11.620535714285714,9.888111888111888,11.5,0.7062937062937062,0.35294117647058826
03-0.5-480-30-10-03-10-15-05,7,255,247,8,140,95,107,11.592,10.07857142857143,11.0,0.6785714285714286,0.4331983805668016
03-0.5-480-30-10-03-10-15-05,8,251,245,6,142,103,103,11.766129032258064,9.943661971830986,11.25242718446602,0.7253521126760564,0.4204081632653061
03-0.5-480-30-10-03-10-15-05,9,241,229,12,140,93,89,11.280172413793103,10.135714285714286,11.348314606741573,0.6642857142857143,0.388646288209607
03-0.5-480-30-10-03-10-15-05,10,218,210,8,141,71,69,10.338028169014084,10.049645390070921,10.043478260869565,0.5035460992907801,0.32857142857142857
03-0.5-480-30-10-03-10-15-05,11,215,204,11,143,67,61,10.115942028985508,9.874125874125873,10.278688524590164,0.46853146853146854,0.29901960784313725
03-0.5-480-30-10-03-10-15-05,12,237,230,7,137,104,93,11.896995708154506,10.408759124087592,11.301075268817204,0.7591240875912408,0.4043478260869565
03-0.5-480-30-10-03-10-15-05,13,255,245,10,147,98,98,11.431451612903226,9.591836734693878,10.959183673469388,0.6666666666666666,0.4
03-0.5-480-30-10-03-10-15-05,14,232,226,6,142,97,84,11.903930131004367,10.0,11.833333333333334,0.6830985915492958,0.37168141592920356
03-0.5-480-30-10-03-10-15-05,15,232,223,9,135,83,88,11.176991150442477,10.540740740740741,11.181818181818182,0.6148148148148148,0.39461883408071746
03-0.5-480-30-10-03-10-15-05,16,246,230,16,141,88,89,11.407725321888412,10.0,11.0561797752809,0.624113475177305,0.3869565217391304
03-0.5-480-30-10-03-10-15-05,17,234,224,10,143,96,81,11.330396475770925,9.895104895104895,10.765432098765432,0.6713286713286714,0.36160714285714285
03-0.5-480-30-10-03-10-15-05,18,225,218,7,137,84,81,11.14027149321267,10.277372262773723,10.469135802469136,0.6131386861313869,0.37155963302752293
03-0.5-480-30-10-03-10-15-05,19,236,233,3,147,84,86,10.754237288135593,9.646258503401361,10.779069767441861,0.5714285714285714,0.36909871244635195
03-0.5-480-30-10-03-10-15-05,20,247,235,12,138,101,97,11.672268907563025,10.231884057971014,11.309278350515465,0.7318840579710145,0.4127659574468085
03-0.5-480-30-10-03-10-15-05,21,241,227,14,138,93,89,11.547826086956523,10.144927536231885,11.03370786516854,0.6739130434782609,0.3920704845814978
03-0.5-480-30-10-03-10-15-05,22,244,235,9,139,110,96,11.978991596638656,10.06474820143885,11.229166666666666,0.7913669064748201,0.4085106382978723
03-0.5-480-30-10-03-10-15-05,23,252,242,10,144,96,98,11.138775510204082,9.743055555555555,10.13265306122449,0.6666666666666666,0.4049586776859504
03-0.5-480-30-10-03-10-15-05,24,247,238,9,144,84,94,11.302904564315353,9.770833333333334,11.27659574468085,0.5833333333333334,0.3949579831932773
03-0.5-480-30-10-03-10-15-05,25,258,252,6,139,97,113,11.509803921568627,10.115107913669064,10.991150442477876,0.697841726618705,0.44841269841269843
03-0.5-480-30-10-03-10-15-05,26,238,230,8,144,105,86,11.53648068669528,9.70138888888889,10.779069767441861,0.7291666666666666,0.3739130434782609
03-0.5-480-30-10-03-10-15-05,27,237,232,5,141,82,91,10.553191489361701,9.943262411347519,10.252747252747254,0.5815602836879432,0.3922413793103448
03-0.5-480-30-10-03-10-15-05,28,242,235,7,138,102,97,11.655462184873949,10.210144927536232,10.742268041237113,0.7391304347826086,0.4127659574468085
03-0.5-480-30-10-03-10-15-05,29,251,236,15,134,94,102,11.861924686192468,10.522388059701493,11.352941176470589,0.7014925373134329,0.4322033898305085
03-0.5-480-30-10-03-10-15-05,30,232,220,12,137,94,83,11.72645739910314,10.291970802919709,11.036144578313253,0.6861313868613139,0.37727272727272726
06-0.5-480-30-10-03-10-15-05,1,234,230,4,230,0,0,0.9829059829059829,10.117391304347827,,0.0,0.0
06-0.5-480-30-10-03-10-15-05,2,240,235,5,235,0,0,0.8875,9.906382978723403,,0.0,0.0
06-0.5-480-30-10-03-10-15-05,3,225,220,5,219,1,1,1.8222222222222222,10.06392694063927,8.0,0.0045662100456621,0.004545454545454545
06-0.5-480-30-10-03-10-15-05,4,231,225,6,223,0,2,0.6363636363636364,10.01793721973094,3.5,0.0,0.008888888888888889
06-0.5-480-30-10-03-10-15-05,5,241,237,4,236,0,1,1.2199170124481329,9.826271186440678,3.0,0.0,0.004219409282700422
06-0.5-480-30-10-03-10-15-05,6,240,237,3,235,1,2,1.4375,9.88936170212766,4.5,0.00425531914893617,0.008438818565400843
06-0.5-480-30-10-03-10-15-05,7,222,219,3,219,0,0,0.42792792792792794,9.65296803652968,,0.0,0.0
06-0.5-480-30-10-03-10-15-05,8,232,227,5,227,0,0,0.5517241379310345,9.687224669603523,,0.0,0.0
06-0.5-480-30-10-03-10-15-05,9,253,248,5,244,2,4,2.6363636363636362,10.307377049180328,6.5,0.00819672131147541,0.016129032258064516
06-0.5-480-30-10-03-10-15-05,10,233,229,4,229,0,0,0.7854077253218884,10.126637554585153,,0.0,0.0
06-0.5-480-30-10-03-10-15-05,11,262,252,10,251,0,1,2.0348837209302326,9.9800796812749,1.0,0.0,0.003968253968253968
06-0.5-480-30-10-03-10-15-05,12,247,243,4,242,0,1,1.611336032388664,9.96694214876033,8.0,0.0,0.00411522633744856
06-0.5-480-30-10-03-10-15-05,13,251,246,5,243,1,3,1.7290836653386454,9.987654320987655,6.0,0.00411522633744856,0.012195121951219513
06-0.5-480-30-10-03-10-15-05,14,218,213,5,213,0,0,0.573394495412844,10.173708920187794,,0.0,0.0
06-0.5-480-30-10-03-10-15-05,15,253,244,9,240,0,4,1.32,10.0375,3.5,0.0,0.01639344262295082
06-0.5-480-30-10-03-10-15-05,16,232,229,3,227,0,2,0.7543103448275862,10.422907488986784,3.0,0.0,0.008733624454148471
06-0.5-480-30-10-03-10-15-05,17,235,230,5,229,0,1,0.8468085106382979,10.013100436681222,4.0,0.0,0.004347826086956522
06-0.5-480-30-10-03-10-15-05,18,239,235,4,232,1,3,1.6945606694560669,10.275862068965518,5.0,0.004310344827586207,0.01276595744680851
06-0.5-480-30-10-03-10-15-05,19,234,231,3,228,0,3,1.7307692307692308,9.947368421052632,4.0,0.0,0.012987012987012988
06-0.5-480-30-10-03-10-15-05,20,261,255,6,253,0,2,1.4252873563218391,9.873517786561266,5.5,0.0,0.00784313725490196
06-0.5-480-30-10-03-10-15-05,21,281,273,8,269,12,4,3.5663082437275984,10.026022304832713,7.25,0.04460966542750929,0.014652014652014652
06-0.5-480-30-10-03-10-15-05,22,246,241,5,240,0,1,1.353658536585366,9.720833333333333,3.0,0.0,0.004149377593360996
06-0.5-480-30-10-03-10-15-05,23,222,216,6,216,0,0,0.8648648648648649,10.00462962962963,,0.0,0.0
06-0.5-480-30-10-03-10-15-05,24,232,229,3,229,0,0,0.9310344827586207,9.812227074235809,,0.0,0.0
06-0.5-480-30-10-03-10-15-05,25,222,217,5,217,0,0,0.5315315315315315,9.746543778801843,,0.0,0.0
06-0.5-480-30-10-03-10-15-05,26,218,214,4,213,0,1,1.055045871559633,9.793427230046948,5.0,0.0,0.004672897196261682
06-0.5-480-30-10-03-10-15-05,27,237,233,4,232,0,1,0.4936708860759494,9.758620689655173,1.0,0.0,0.004291845493562232
06-0.5-480-30-10-03-10-15-05,28,233,229,4,226,0,3,1.6523605150214593,9.946902654867257,5.333333333333333,0.0,0.013100436681222707
06-0.5-480-30-10-03-10-15-05,29,251,246,5,246,0,0,1.1832669322709164,9.674796747967479,,0.0,0.0
06-0.5-480-30-10-03-10-15-05,30,230,225,5,222,0,3,1.126086956521739,10.031531531531531,4.333333333333333,0.0,0.013333333333333334
09-0.5-480-30-10-03-10-15-05,1,238,235,3,235,0,0,0.012605042016806723,10.136170212765958,,0.0,0.0
09-0.5-480-30-10-03-10-15-05,2,218,212,6,212,0,0,0.027522935779816515,10.160377358490566,,0.0,0.0
09-0.5-480-30-10-03-10-15-05,3,224,218,6,218,0,0,0.022321428571428572,10.325688073394495,,0.0,0.0
09-0.5-480-30-10-03-10-15-05,4,241,235,6,235,0,0,0.02074688796680498,9.757446808510638,,0.0,0.0
09-0.5-480-30-10-03-10-15-05,5,226,222,4,222,0,0,0.0,9.896396396396396,,0.0,0.0
09-0.5-480-30-10-03-10-15-05,6,240,232,8,232,0,0,0.020833333333333332,9.900862068965518,,0.0,0.0
09-0.5-480-30-10-03-10-15-05,7,229,222,7,222,0,0,0.039301310043668124,10.17117117117117,,0.0,0.0
09-0.5-480-30-10-03-10-15-05,8,236,232,4,232,0,0,0.046610169491525424,10.047413793103448,,0.0,0.0
09-0.5-480-30-10-03-10-15-05,9,249,243,6,243,0,0,0.060240963855421686,9.983539094650206,,0.0,0.0
09-0.5-480-30-10-03-10-15-05,10,244,239,5,239,0,0,0.01639344262295082,10.460251046025105,,0.0,0.0
09-0.5-480-30-10-03-10-15-05,11,219,213,6,213,0,0,0.0182648401826484,9.924882629107982,,0.0,0.0
09-0.5-480-30-10-03-10-15-05,12,260,253,7,253,0,0,0.17307692307692307,10.019762845849803,,0.0,0.0
09-0.5-480-30-10-03-10-15-05,13,218,214,4,214,0,0,0.0045871559633027525,10.205607476635514,,0.0,0.0
09-0.5-480-30-10-03-10-15-05,14,249,243,6,243,0,0,0.012048192771084338,9.814814814814815,,0.0,0.0
09-0.5-480-30-10-03-10-15-05,15,240,235,5,235,0,0,0.0375,10.059574468085106,,0.0,0.0
09-0.5-480-30-10-03-10-15-05,16,234,227,7,227,0,0,0.042735042735042736,9.374449339207048,,0.0,0.0
09-0.5-480-30-10-03-10-15-05,17,219,214,5,214,0,0,0.0273972602739726,9.61214953271028,,0.0,0.0
09-0.5-480-30-10-03-10-15-05,18,242,231,11,231,0,0,0.0125,9.943722943722944,,0.0,0.0
09-0.5-480-30-10-03-10-15-05,19,235,231,4,231,0,0,0.0851063829787234,10.012987012987013,,0.0,0.0
09-0.5-480-30-10-03-10-15-05,20,246,240,6,240,0,0,0.012195121951219513,9.9375,,0.0,0.0
09-0.5-480-30-10-03-10-15-05,21,259,255,4,254,0,1,0.07722007722007722,9.854330708661417,1.0,0.0,0.00392156862745098
09-0.5-480-30-10-03-10-15-05,22,235,228,7,228,0,0,0.06382978723404255,10.162280701754385,,0.0,0.0
09-0.5-480-30-10-03-10-15-05,23,232,228,4,228,0,0,0.03879310344827586,10.50438596491228,,0.0,0.0
09-0.5-480-30-10-03-10-15-05,24,236,233,3,233,0,0,0.059322033898305086,9.866952789699571,,0.0,0.0
09-0.5-480-30-10-03-10-15-05,25,232,227,5,227,0,0,0.0,9.832599118942731,,0.0,0.0
09-0.5-480-30-10-03-10-15-05,26,235,231,4,231,0,0,0.05531914893617021,9.987012987012987,,0.0,0.0
09-0.5-480-30-10-03-10-15-05,27,235,232,3,232,0,0,0.02553191489361702,9.987068965517242,,0.0,0.0
09-0.5-480-30-10-03-10-15-05,28,222,216,6,216,0,0,0.06756756756756757,10.078703703703704,,0.0,0.0
09-0.5-480-30-10-03-10-15-05,29,243,236,7,236,0,0,0.00411522633744856,9.694915254237289,,0.0,0.0
09-0.5-480-30-10-03-10-15-05,30,247,243,4,242,0,1,0.044534412955465584,9.954545454545455,1.0,0.0,0.00411522633744856
12-0.5-480-30-10-03-10-15-05,1,241,236,5,236,0,0,0.0,9.915254237288135,,0.0,0.0
12-0.5-480-30-10-03-10-15-05,2,252,249,3,249,0,0,0.0,10.38152610441767,,0.0,0.0
12-0.5-480-30-10-03-10-15-05,3,251,247,4,247,0,0,0.0,9.959514170040485,,0.0,0.0
12-0.5-480-30-10-03-10-15-05,4,255,252,3,252,0,0,0.0,9.884920634920634,,0.0,0.0
12-0.5-480-30-10-03-10-15-05,5,226,221,5,221,0,0,0.0,9.55656108597285,,0.0,0.0
12-0.5-480-30-10-03-10-15-05,6,247,240,7,240,0,0,0.0,10.091666666666667,,0.0,0.0
12-0.5-480-30-10-03-10-15-05,7,240,231,9,231,0,0,0.0,9.545454545454545,,0.0,0.0
12-0.5-480-30-10-03-10-15-05,8,232,226,6,226,0,0,0.0,10.446902654867257,,0.0,0.0
12-0.5-480-30-10-03-10-15-05,9,234,228,6,228,0,0,0.0,10.192982456140351,,0.0,0.0
12-0.5-480-30-10-03-10-15-05,10,225,224,1,224,0,0,0.0,9.602678571428571,,0.0,0.0
12-0.5-480-30-10-03-10-15-05,11,240,236,4,236,0,0,0.0,10.097457627118644,,0.0,0.0
12-0.5-480-30-10-03-10-15-05,12,248,240,8,240,0,0,0.0,10.291666666666666,,0.0,0.0
12-0.5-480-30-10-03-10-15-05,13,246,241,5,241,0,0,0.0,9.67219917012448,,0.0,0.0
12-0.5-480-30-10-03-10-15-05,14,252,248,4,248,0,0,0.0,10.016129032258064,,0.0,0.0
12-0.5-480-30-10-03-10-15-05,15,226,222,4,222,0,0,0.0,9.936936936936936,,0.0,0.0
12-0.5-480-30-10-03-10-15-05,16,245,238,7,238,0,0,0.0,9.974789915966387,,0.0,0.0
12-0.5-480-30-10-03-10-15-05,17,242,238,4,238,0,0,0.0,10.289915966386555,,0.0,0.0
12-0.5-480-30-10-03-10-15-05,18,231,227,4,227,0,0,0.0,9.823788546255507,,0.0,0.0
12-0.5-480-30-10-03-10-15-05,19,234,230,4,230,0,0,0.0,10.091304347826087,,0.0,0.0
12-0.5-480-30-10-03-10-15-05,20,253,250,3,250,0,0,0.0,9.96,,0.0,0.0
12-0.5-480-30-10-03-10-15-05,21,232,226,6,226,0,0,0.0,9.9070796460177,,0.0,0.0
12-0.5-480-30-10-03-10-15-05,22,249,242,7,242,0,0,0.0,9.896694214876034,,0.0,0.0
12-0.5-480-30-10-03-10-15-05,23,238,232,6,232,0,0,0.0,9.724137931034482,,0.0,0.0
12-0.5-480-30-10-03-10-15-05,24,239,234,5,234,0,0,0.0,10.132478632478632,,0.0,0.0
12-0.5-480-30-10-03-10-15-05,25,225,221,4,221,0,0,0.0,10.117647058823529,,0.0,0.0
12-0.5-480-30-10-03-10-15-05,26,246,241,5,241,0,0,0.0,9.879668049792532,,0.0,0.0
12-0.5-480-30-10-03-10-15-05,27,251,247,4,247,0,0,0.0,10.0,,0.0,0.0
12-0.5-480-30-10-03-10-15-05,28,235,229,6,229,0,0,0.0,9.882096069868995,,0.0,0.0
12-0.5-480-30-10-03-10-15-05,29,235,226,9,226,0,0,0.0,10.030973451327434,,0.0,0.0
12-0.5-480-30-10-03-10-15-05,30,233,229,4,229,0,0,0.0,10.14410480349345,,0.0,0.0
15-0.5-480-30-10-03-10-15-05,1,246,239,7,239,0,0,0.0,10.100418410041842,,0.0,0.0
15-0.5-480-30-10-03-10-15-05,2,246,241,5,241,0,0,0.0,9.809128630705395,,0.0,0.0
15-0.5-480-30-10-03-10-15-05,3,231,228,3,228,0,0,0.0,9.552631578947368,,0.0,0.0
15-0.5-480-30-10-03-10-15-05,4,248,244,4,244,0,0,0.0,9.819672131147541,,0.0,0.0
15-0.5-480-30-10-03-10-15-05,5,244,238,6,238,0,0,0.0,10.441176470588236,,0.0,0.0
15-0.5-480-30-10-03-10-15-05,6,237,232,5,232,0,0,0.0,9.991379310344827,,0.0,0.0
15-0.5-480-30-10-03-10-15-05,7,251,245,6,245,0,0,0.0,9.881632653061224,,0.0,0.0
15-0.5-480-30-10-03-10-15-05,8,212,207,5,207,0,0,0.0,9.956521739130435,,0.0,0.0
15-0.5-480-30-10-03-10-15-05,9,236,231,5,231,0,0,0.0,10.16017316017316,,0.0,0.0
15-0.5-480-30-10-03-10-15-05,10,243,239,4,239,0,0,0.0,10.121338912133892,,0.0,0.0
15-0.5-480-30-10-03-10-15-05,11,261,253,8,253,0,0,0.0,9.865612648221344,,0.0,0.0
15-0.5-480-30-10-03-10-15-05,12,260,253,7,253,0,0,0.0,10.26086956521739,,0.0,0.0
15-0.5-480-30-10-03-10-15-05,13,212,206,6,206,0,0,0.0,10.179611650485437,,0.0,0.0
15-0.5-480-30-10-03-10-15-05,14,233,230,3,230,0,0,0.0,10.130434782608695,,0.0,0.0
15-0.5-480-30-10-03-10-15-05,15,239,236,3,236,0,0,0.0,9.927966101694915,,0.0,0.0
15-0.5-480-30-10-03-10-15-05,16,246,240,6,240,0,0,0.0,10.066666666666666,,0.0,0.0
15-0.5-480-30-10-03-10-15-05,17,237,230,7,230,0,0,0.0,9.882608695652173,,0.0,0.0
15-0.5-480-30-10-03-10-15-05,18,243,241,2,241,0,0,0.0,10.070539419087137,,0.0,0.0
15-0.5-480-30-10-03-10-15-05,19,222,220,2,220,0,0,0.0,9.922727272727272,,0.0,0.0
15-0.5-480-30-10-03-10-15-05,20,248,245,3,245,0,0,0.0,10.19591836734694,,0.0,0.0
15-0.5-480-30-10-03-10-15-05,21,232,226,6,226,0,0,0.0,10.225663716814159,,0.0,0.0
15-0.5-480-30-10-03-10-15-05,22,230,227,3,227,0,0,0.0,9.832599118942731,,0.0,0.0
15-0.5-480-30-10-03-10-15-05,23,244,241,3,241,0,0,0.0,10.112033195020746,,0.0,0.0
15-0.5-480-30-10-03-10-15-05,24,246,240,6,240,0,0,0.0,10.166666666666666,,0.0,0.0
15-0.5-480-30-10-03-10-15-05,25,238,228,10,228,0,0,0.0,9.653508771929825,,0.0,0.0
15-0.5-480-30-10-03-10-15-05,26,228,224,4,224,0,0,0.0,10.205357142857142,,0.0,0.0
15-0.5-480-30-10-03-10-15-05,27,243,240,3,240,0,0,0.0,10.029166666666667,,0.0,0.0
15-0.5-480-30-10-03-10-15-05,28,249,243,6,243,0,0,0.0,9.901234567901234,,0.0,0.0
15-0.5-480-30-10-03-10-15-05,29,265,260,5,260,0,0,0.0,9.95,,0.0,0.0
15-0.5-480-30-10-03-10-15-05,30,245,240,5,240,0,0,0.0,9.975,,0.0,0.0
18-0.5-480-30-10-03-10-15-05,1,230,226,4,226,0,0,0.0,9.924778761061948,,0.0,0.0
18-0.5-480-30-10-03-10-15-05,2,249,243,6,243,0,0,0.0,9.876543209876543,,0.0,0.0
18-0.5-480-30-10-03-10-15-05,3,240,236,4,236,0,0,0.0,9.915254237288135,,0.0,0.0
18-0.5-480-30-10-03-10-15-05,4,235,231,4,231,0,0,0.0,10.142857142857142,,0.0,0.0
18-0.5-480-30-10-03-10-15-05,5,225,218,7,218,0,0,0.0,9.963302752293577,,0.0,0.0
18-0.5-480-30-10-03-10-15-05,6,236,232,4,232,0,0,0.0,9.823275862068966,,0.0,0.0
18-0.5-480-30-10-03-10-15-05,7,223,218,5,218,0,0,0.0,10.105504587155963,,0.0,0.0
18-0.5-480-30-10-03-10-15-05,8,243,238,5,238,0,0,0.0,9.596638655462185,,0.0,0.0
18-0.5-480-30-10-03-10-15-05,9,244,238,6,238,0,0,0.0,10.247899159663865,,0.0,0.0
18-0.5-480-30-10-03-10-15-05,10,229,225,4,225,0,0,0.0,9.991111111111111,,0.0,0.0
18-0.5-480-30-10-03-10-15-05,11,271,265,6,265,0,0,0.0,9.754716981132075,,0.0,0.0
18-0.5-480-30-10-03-10-15-05,12,239,232,7,232,0,0,0.0,10.043103448275861,,0.0,0.0
18-0.5-480-30-10-03-10-15-05,13,268,264,4,264,0,0,0.0,10.068181818181818,,0.0,0.0
18-0.5-480-30-10-03-10-15-05,14,244,240,4,240,0,0,0.0,9.7625,,0.0,0.0
18-0.5-480-30-10-03-10-15-05,15,237,230,7,230,0,0,0.0,9.969565217391304,,0.0,0.0
18-0.5-480-30-10-03-10-15-05,16,241,233,8,233,0,0,0.0,9.639484978540773,,0.0,0.0
18-0.5-480-30-10-03-10-15-05,17,225,220,5,220,0,0,0.0,10.2,,0.0,0.0
18-0.5-480-30-10-03-10-15-05,18,253,249,4,249,0,0,0.0,9.983935742971887,,0.0,0.0
18-0.5-480-30-10-03-10-15-05,19,245,240,5,240,0,0,0.0,10.154166666666667,,0.0,0.0
18-0.5-480-30-10-03-10-15-05,20,230,223,7,223,0,0,0.0,10.161434977578475,,0.0,0.0
18-0.5-480-30-10-03-10-15-05,21,253,246,7,246,0,0,0.0,9.91869918699187,,0.0,0.0
18-0.5-480-30-10-03-10-15-05,22,258,253,5,253,0,0,0.0,10.118577075098814,,0.0,0.0
18-0.5-480-30-10-03-10-15-05,23,240,233,7,233,0,0,0.0,10.360515021459227,,0.0,0.0
18-0.5-480-30-10-03-10-15-05,24,238,230,8,230,0,0,0.0,9.982608695652173,,0.0,0.0
18-0.5-480-30-10-03-10-15-05,25,232,227,5,227,0,0,0.0,9.837004405286343,,0.0,0.0
18-0.5-480-30-10-03-10-15-05,26,224,220,4,220,0,0,0.0,9.963636363636363,,0.0,0.0
18-0.5-480-30-10-03-10-15-05,27,247,242,5,242,0,0,0.0,9.640495867768594,,0.0,0.0
18-0.5-480-30-10-03-10-15-05,28,223,219,4,219,0,0,0.0,9.908675799086758,,0.0,0.0
18-0.5-480-30-10-03-10-15-05,29,241,239,2,239,0,0,0.0,9.97071129707113,,0.0,0.0
18-0.5-480-30-10-03-10-15-05,30,237,233,4,233,0,0,0.0,10.313304721030043,,0.0,0.0
21-0.5-480-30-10-03-10-15-05,1,237,230,7,230,0,0,0.0,9.882608695652173,,0.0,0.0
21-0.5-480-30-10-03-10-15-05,2,241,238,3,238,0,0,0.0,9.8109243697479,,0.0,0.0
21-0.5-480-30-10-03-10-15-05,3,236,230,6,230,0,0,0.0,10.034782608695652,,0.0,0.0
21-0.5-480-30-10-03-10-15-05,4,239,235,4,235,0,0,0.0,9.91063829787234,,0.0,0.0
21-0.5-480-30-10-03-10-15-05,5,237,234,3,234,0,0,0.0,9.713675213675213,,0.0,0.0
21-0.5-480-30-10-03-10-15-05,6,253,245,8,245,0,0,0.0,9.971428571428572,,0.0,0.0
21-0.5-480-30-10-03-10-15-05,7,249,246,3,246,0,0,0.0,10.0,,0.0,0.0
21-0.5-480-30-10-03-10-15-05,8,249,244,5,244,0,0,0.0,10.172131147540984,,0.0,0.0
21-0.5-480-30-10-03-10-15-05,9,241,236,5,236,0,0,0.0,9.974576271186441,,0.0,0.0
21-0.5-480-30-10-03-10-15-05,10,230,224,6,224,0,0,0.0,9.915178571428571,,0.0,0.0
21-0.5-480-30-10-03-10-15-05,11,235,232,3,232,0,0,0.0,9.810344827586206,,0.0,0.0
21-0.5-480-30-10-03-10-15-05,12,239,235,4,235,0,0,0.0,10.259574468085106,,0.0,0.0
21-0.5-480-30-10-03-10-15-05,13,236,232,4,232,0,0,0.0,9.922413793103448,,0.0,0.0
21-0.5-480-30-10-03-10-15-05,14,222,218,4,218,0,0,0.0,9.688073394495413,,0.0,0.0
21-0.5-480-30-10-03-10-15-05,15,227,223,4,223,0,0,0.0,9.695067264573991,,0.0,0.0
21-0.5-480-30-10-03-10-15-05,16,245,237,8,237,0,0,0.0,9.940928270042194,,0.0,0.0
21-0.5-480-30-10-03-10-15-05,17,238,236,2,236,0,0,0.0,10.385593220338983,,0.0,0.0
21-0.5-480-30-10-03-10-15-05,18,259,253,6,253,0,0,0.0,9.960474308300395,,0.0,0.0
21-0.5-480-30-10-03-10-15-05,19,240,237,3,237,0,0,0.0,10.08860759493671,,0.0,0.0
21-0.5-480-30-10-03-10-15-05,20,242,237,5,237,0,0,0.0,9.573839662447257,,0.0,0.0
21-0.5-480-30-10-03-10-15-05,21,258,250,8,250,0,0,0.0,9.716,,0.0,0.0
21-0.5-480-30-10-03-10-15-05,22,238,232,6,232,0,0,0.0,10.224137931034482,,0.0,0.0
21-0.5-480-30-10-03-10-15-05,23,249,245,4,245,0,0,0.0,9.473469387755102,,0.0,0.0
21-0.5-480-30-10-03-10-15-05,24,244,241,3,241,0,0,0.0,9.892116182572614,,0.0,0.0
21-0.5-480-30-10-03-10-15-05,25,230,227,3,227,0,0,0.0,10.17180616740088,,0.0,0.0
21-0.5-480-30-10-03-10-15-05,26,233,228,5,228,0,0,0.0,9.978070175438596,,0.0,0.0
21-0.5-480-30-10-03-10-15-05,27,216,211,5,211,0,0,0.0,9.947867298578199,,0.0,0.0
21-0.5-480-30-10-03-10-15-05,28,243,239,4,239,0,0,0.0,10.02928870292887,,0.0,0.0
21-0.5-480-30-10-03-10-15-05,29,259,255,4,255,0,0,0.0,10.027450980392157,,0.0,0.0
21-0.5-480-30-10-03-10-15-05,30,236,231,5,231,0,0,0.0,10.402597402597403,,0.0,0.0
24-0.5-480-30-10-03-10-15-05,1,233,228,5,228,0,0,0.0,10.100877192982455,,0.0,0.0
24-0.5-480-30-10-03-10-15-05,2,223,218,5,218,0,0,0.0,10.174311926605505,,0.0,0.0
24-0.5-480-30-10-03-10-15-05,3,248,245,3,245,0,0,0.0,9.885714285714286,,0.0,0.0
24-0.5-480-30-10-03-10-15-05,4,246,238,8,238,0,0,0.0,9.731092436974789,,0.0,0.0
24-0.5-480-30-10-03-10-15-05,5,242,238,4,238,0,0,0.0,9.865546218487395,,0.0,0.0
24-0.5-480-30-10-03-10-15-05,6,233,228,5,228,0,0,0.0,10.114035087719298,,0.0,0.0
24-0.5-480-30-10-03-10-15-05,7,234,229,5,229,0,0,0.0,10.235807860262009,,0.0,0.0
24-0.5-480-30-10-03-10-15-05,8,234,228,6,228,0,0,0.0,10.232456140350877,,0.0,0.0
24-0.5-480-30-10-03-10-15-05,9,241,236,5,236,0,0,0.0,10.09322033898305,,0.0,0.0
24-0.5-480-30-10-03-10-15-05,10,241,235,6,235,0,0,0.0,9.914893617021276,,0.0,0.0
24-0.5-480-30-10-03-10-15-05,11,232,228,4,228,0,0,0.0,9.859649122807017,,0.0,0.0
24-0.5-480-30-10-03-10-15-05,12,258,254,4,254,0,0,0.0,10.003937007874017,,0.0,0.0
24-0.5-480-30-10-03-10-15-05,13,246,239,7,239,0,0,0.0,10.087866108786612,,0.0,0.0
24-0.5-480-30-10-03-10-15-05,14,250,243,7,243,0,0,0.0,9.905349794238683,,0.0,0.0
24-0.5-480-30-10-03-10-15-05,15,240,237,3,237,0,0,0.0,9.940928270042194,,0.0,0.0
24-0.5-480-30-10-03-10-15-05,16,234,227,7,227,0,0,0.0,10.026431718061675,,0.0,0.0
24-0.5-480-30-10-03-10-15-05,17,219,216,3,216,0,0,0.0,9.791666666666666,,0.0,0.0
24-0.5-480-30-10-03-10-15-05,18,242,238,4,238,0,0,0.0,9.899159663865547,,0.0,0.0
24-0.5-480-30-10-03-10-15-05,19,215,210,5,210,0,0,0.0,10.17142857142857,,0.0,0.0
24-0.5-480-30-10-03-10-15-05,20,264,260,4,260,0,0,0.0,10.092307692307692,,0.0,0.0
24-0.5-480-30-10-03-10-15-05,21,227,223,4,223,0,0,0.0,10.085201793721973,,0.0,0.0
24-0.5-480-30-10-03-10-15-05,22,246,240,6,240,0,0,0.0,9.929166666666667,,0.0,0.0
24-0.5-480-30-10-03-10-15-05,23,236,230,6,230,0,0,0.0,10.26086956521739,,0.0,0.0
24-0.5-480-30-10-03-10-15-05,24,239,235,4,235,0,0,0.0,9.646808510638298,,0.0,0.0
24-0.5-480-30-10-03-10-15-05,25,243,238,5,238,0,0,0.0,10.373949579831933,,0.0,0.0
24-0.5-480-30-10-03-10-15-05,26,228,222,6,222,0,0,0.0,9.981981981981981,,0.0,0.0
24-0.5-480-30-10-03-10-15-05,27,216,213,3,213,0,0,0.0,9.633802816901408,,0.0,0.0
24-0.5-480-30-10-03-10-15-05,28,244,239,5,239,0,0,0.0,9.518828451882845,,0.0,0.0
24-0.5-480-30-10-03-10-15-05,29,242,239,3,239,0,0,0.0,9.907949790794978,,0.0,0.0
24-0.5-480-30-10-03-10-15-05,30,245,240,5,240,0,0,0.0,10.1875,,0.0,0.0
27-0.5-480-30-10-03-10-15-05,1,241,236,5,236,0,0,0.0,9.864406779661017,,0.0,0.0
27-0.5-480-30-10-03-10-15-05,2,228,222,6,222,0,0,0.0,9.981981981981981,,0.0,0.0
27-0.5-480-30-10-03-10-15-05,3,240,236,4,236,0,0,0.0,10.029661016949152,,0.0,0.0
27-0.5-480-30-10-03-10-15-05,4,242,238,4,238,0,0,0.0,10.042016806722689,,0.0,0.0
27-0.5-480-30-10-03-10-15-05,5,255,251,4,251,0,0,0.0,9.828685258964143,,0.0,0.0
27-0.5-480-30-10-03-10-15-05,6,221,218,3,218,0,0,0.0,9.899082568807339,,0.0,0.0
27-0.5-480-30-10-03-10-15-05,7,247,243,4,243,0,0,0.0,9.91769547325103,,0.0,0.0
27-0.5-480-30-10-03-10-15-05,8,249,243,6,243,0,0,0.0,10.160493827160494,,0.0,0.0
27-0.5-480-30-10-03-10-15-05,9,242,239,3,239,0,0,0.0,10.01255230125523,,0.0,0.0
27-0.5-480-30-10-03-10-15-05,10,226,218,8,218,0,0,0.0,10.022935779816514,,0.0,0.0
27-0.5-480-30-10-03-10-15-05,11,240,233,7,233,0,0,0.0,9.849785407725323,,0.0,0.0
27-0.5-480-30-10-03-10-15-05,12,245,242,3,242,0,0,0.0,9.74793388429752,,0.0,0.0
27-0.5-480-30-10-03-10-15-05,13,241,237,4,237,0,0,0.0,9.949367088607595,,0.0,0.0
27-0.5-480-30-10-03-10-15-05,14,232,229,3,229,0,0,0.0,9.982532751091703,,0.0,0.0
27-0.5-480-30-10-03-10-15-05,15,224,219,5,219,0,0,0.0,9.876712328767123,,0.0,0.0
27-0.5-480-30-10-03-10-15-05,16,236,227,9,227,0,0,0.0,10.286343612334802,,0.0,0.0
27-0.5-480-30-10-03-10-15-05,17,242,239,3,239,0,0,0.0,10.280334728033473,,0.0,0.0
27-0.5-480-30-10-03-10-15-05,18,233,231,2,231,0,0,0.0,9.774891774891774,,0.0,0.0
27-0.5-480-30-10-03-10-15-05,19,243,239,4,239,0,0,0.0,9.836820083682008,,0.0,0.0
27-0.5-480-30-10-03-10-15-05,20,229,223,6,223,0,0,0.0,9.762331838565023,,0.0,0.0
27-0.5-480-30-10-03-10-15-05,21,237,230,7,230,0,0,0.0,10.034782608695652,,0.0,0.0
27-0.5-480-30-10-03-10-15-05,22,222,216,6,216,0,0,0.0,9.87037037037037,,0.0,0.0
27-0.5-480-30-10-03-10-15-05,23,240,234,6,234,0,0,0.0,10.094017094017094,,0.0,0.0
27-0.5-480-30-10-03-10-15-05,24,256,253,3,253,0,0,0.0,10.08300395256917,,0.0,0.0
27-0.5-480-30-10-03-10-15-05,25,226,221,5,221,0,0,0.0,9.868778280542987,,0.0,0.0
27-0.5-480-30-10-03-10-15-05,26,225,221,4,221,0,0,0.0,9.895927601809955,,0.0,0.0
27-0.5-480-30-10-03-10-15-05,27,219,216,3,216,0,0,0.0,9.939814814814815,,0.0,0.0
27-0.5-480-30-10-03-10-15-05,28,227,223,4,223,0,0,0.0,9.766816143497758,,0.0,0.0
27-0.5-480-30-10-03-10-15-05,29,237,231,6,231,0,0,0.0,9.969696969696969,,0.0,0.0
27-0.5-480-30-10-03-10-15-05,30,252,248,4,248,0,0,0.0,10.040322580645162,,0.0,0.0
30-0.5-480-30-10-03-10-15-05,1,223,219,4,219,0,0,0.0,9.867579908675799,,0.0,0.0
30-0.5-480-30-10-03-10-15-05,2,243,237,6,237,0,0,0.0,10.324894514767932,,0.0,0.0
30-0.5-480-30-10-03-10-15-05,3,227,220,7,220,0,0,0.0,10.00909090909091,,0.0,0.0
30-0.5-480-30-10-03-10-15-05,4,223,220,3,220,0,0,0.0,10.031818181818181,,0.0,0.0
30-0.5-480-30-10-03-10-15-05,5,233,231,2,231,0,0,0.0,10.229437229437229,,0.0,0.0
30-0.5-480-30-10-03-10-15-05,6,232,227,5,227,0,0,0.0,10.334801762114537,,0.0,0.0
30-0.5-480-30-10-03-10-15-05,7,239,234,5,234,0,0,0.0,9.854700854700855,,0.0,0.0
30-0.5-480-30-10-03-10-15-05,8,226,220,6,220,0,0,0.0,9.886363636363637,,0.0,0.0
30-0.5-480-30-10-03-10-15-05,9,236,235,1,235,0,0,0.0,9.821276595744681,,0.0,0.0
30-0.5-480-30-10-03-10-15-05,10,255,251,4,251,0,0,0.0,9.569721115537849,,0.0,0.0
30-0.5-480-30-10-03-10-15-05,11,239,234,5,234,0,0,0.0,9.987179487179487,,0.0,0.0
30-0.5-480-30-10-03-10-15-05,12,248,243,5,243,0,0,0.0,9.983539094650206,,0.0,0.0
30-0.5-480-30-10-03-10-15-05,13,225,217,8,217,0,0,0.0,10.387096774193548,,0.0,0.0
30-0.5-480-30-10-03-10-15-05,14,211,205,6,205,0,0,0.0,9.71219512195122,,0.0,0.0
30-0.5-480-30-10-03-10-15-05,15,241,237,4,237,0,0,0.0,9.691983122362869,,0.0,0.0
30-0.5-480-30-10-03-10-15-05,16,235,230,5,230,0,0,0.0,10.1,,0.0,0.0
30-0.5-480-30-10-03-10-15-05,17,239,236,3,236,0,0,0.0,9.923728813559322,,0.0,0.0
30-0.5-480-30-10-03-10-15-05,18,238,235,3,235,0,0,0.0,10.34468085106383,,0.0,0.0
30-0.5-480-30-10-03-10-15-05,19,243,240,3,240,0,0,0.0,9.5,,0.0,0.0
30-0.5-480-30-10-03-10-15-05,20,259,249,10,249,0,0,0.0,10.012048192771084,,0.0,0.0
30-0.5-480-30-10-03-10-15-05,21,227,222,5,222,0,0,0.0,9.981981981981981,,0.0,0.0
30-0.5-480-30-10-03-10-15-05,22,226,223,3,223,0,0,0.0,9.838565022421525,,0.0,0.0
30-0.5-480-30-10-03-10-15-05,23,240,233,7,233,0,0,0.0,9.982832618025752,,0.0,0.0
30-0.5-480-30-10-03-10-15-05,24,246,244,2,244,0,0,0.0,9.954918032786885,,0.0,0.0
30-0.5-480-30-10-03-10-15-05,25,253,246,7,246,0,0,0.0,9.90650406504065,,0.0,0.0
30-0.5-480-30-10-03-10-15-05,26,228,226,2,226,0,0,0.0,9.938053097345133,,0.0,0.0
30-0.5-480-30-10-03-10-15-05,27,247,242,5,242,0,0,0.0,10.020661157024794,,0.0,0.0
30-0.5-480-30-10-03-10-15-05,28,256,254,2,254,0,0,0.0,9.84251968503937,,0.0,0.0
30-0.5-480-30-10-03-10-15-05,29,221,215,6,215,0,0,0.0,10.2,,0.0,0.0
30-0.5-480-30-10-03-10-15-05,30,268,262,6,262,0,0,0.0,9.977099236641221,,0.0,0.0
03-01-480-30-10-03-10-15-05,1,466,447,19,143,131,304,13.715555555555556,9.86013986013986,12.733552631578947,0.916083916083916,0.680089485458613
03-01-480-30-10-03-10-15-05,2,490,470,20,147,142,323,13.632135306553911,9.63265306122449,12.693498452012383,0.9659863945578231,0.6872340425531915
03-01-480-30-10-03-10-15-05,3,459,439,20,139,128,300,13.891402714932127,10.086330935251798,13.316666666666666,0.920863309352518,0.683371298405467
03-01-480-30-10-03-10-15-05,4,483,464,19,138,131,326,13.84796573875803,10.297101449275363,12.776073619631902,0.9492753623188406,0.7025862068965517
03-01-480-30-10-03-10-15-05,5,513,481,32,137,134,344,13.847107438016529,10.306569343065693,12.80232558139535,0.9781021897810219,0.7151767151767152
03-01-480-30-10-03-10-15-05,6,504,480,24,143,138,337,14.091097308488612,9.79020979020979,13.1513353115727,0.965034965034965,0.7020833333333333
03-01-480-30-10-03-10-15-05,7,455,429,26,140,132,289,13.550925925925926,10.2,12.647058823529411,0.9428571428571428,0.6736596736596736
03-01-480-30-10-03-10-15-05,8,465,445,20,137,130,308,13.772321428571429,10.27007299270073,13.087662337662337,0.948905109489051,0.6921348314606741
03-01-480-30-10-03-10-15-05,9,487,457,30,146,141,311,14.019565217391305,9.657534246575343,13.241157556270096,0.9657534246575342,0.6805251641137856
03-01-480-30-10-03-10-15-05,10,480,460,20,140,131,320,13.68682505399568,10.157142857142857,13.05,0.9357142857142857,0.6956521739130435
03-01-480-30-10-03-10-15-05,11,486,466,20,154,141,312,13.884861407249467,9.2987012987013,12.974358974358974,0.9155844155844156,0.6695278969957081
03-01-480-30-10-03-10-15-05,12,490,470,20,140,135,330,13.805496828752643,10.157142857142857,13.103030303030303,0.9642857142857143,0.7021276595744681
03-01-480-30-10-03-10-15-05,13,482,463,19,144,141,319,13.843347639484978,9.930555555555555,12.689655172413794,0.9791666666666666,0.6889848812095032
03-01-480-30-10-03-10-15-05,14,454,435,19,145,138,290,13.648401826484019,9.689655172413794,12.593103448275862,0.9517241379310345,0.6666666666666666
03-01-480-30-10-03-10-15-05,15,448,428,20,144,141,284,13.635730858468678,9.784722222222221,12.630281690140846,0.9791666666666666,0.6635514018691588
03-01-480-30-10-03-10-15-05,16,451,435,16,138,129,297,13.650684931506849,10.22463768115942,12.858585858585858,0.9347826086956522,0.6827586206896552
03-01-480-30-10-03-10-15-05,17,495,476,19,142,139,334,14.110647181628392,9.97887323943662,13.104790419161677,0.9788732394366197,0.7016806722689075
03-01-480-30-10-03-10-15-05,18,462,437,25,144,138,293,13.965909090909092,9.895833333333334,12.914675767918089,0.9583333333333334,0.6704805491990846
03-01-480-30-10-03-10-15-05,19,488,470,18,144,141,326,13.980972515856237,9.875,12.904907975460123,0.9791666666666666,0.6936170212765957
03-01-480-30-10-03-10-15-05,20,462,440,22,143,137,297,13.869074492099323,9.86013986013986,12.875420875420875,0.958041958041958,0.675
03-01-480-30-10-03-10-15-05,21,503,480,23,144,139,336,13.407867494824016,9.722222222222221,12.568452380952381,0.9652777777777778,0.7
03-01-480-30-10-03-10-15-05,22,468,450,18,141,138,309,14.154525386313466,10.049645390070921,13.055016181229773,0.9787234042553191,0.6866666666666666
03-01-480-30-10-03-10-15-05,23,460,438,22,143,136,295,13.365079365079366,9.874125874125873,12.589830508474575,0.951048951048951,0.6735159817351598
03-01-480-30-10-03-10-15-05,24,499,477,22,141,137,336,13.708333333333334,10.099290780141844,12.824404761904763,0.9716312056737588,0.7044025157232704
03-01-480-30-10-03-10-15-05,25,508,490,18,138,137,352,14.33265720081136,10.253623188405797,13.372159090909092,0.9927536231884058,0.7183673469387755
03-01-480-30-10-03-10-15-05,26,472,445,27,145,139,300,14.044642857142858,9.786206896551723,13.063333333333333,0.9586206896551724,0.6741573033707865
03-01-480-30-10-03-10-15-05,27,475,447,28,135,129,312,13.346666666666666,10.503703703703703,12.432692307692308,0.9555555555555556,0.697986577181208
03-01-480-30-10-03-10-15-05,28,499,479,20,138,134,341,14.04149377593361,10.253623188405797,13.117302052785924,0.9710144927536232,0.7118997912317327
03-01-480-30-10-03-10-15-05,29,433,412,21,142,133,270,13.946987951807229,9.943661971830986,12.892592592592592,0.9366197183098591,0.6553398058252428
03-01-480-30-10-03-10-15-05,30,472,452,20,144,137,308,13.248351648351647,9.743055555555555,12.311688311688311,0.9513888888888888,0.6814159292035398
06-01-480-30-10-03-10-15-05,1,468,448,20,278,196,170,11.77092511013216,10.161870503597122,11.023529411764706,0.7050359712230215,0.3794642857142857
06-01-480-30-10-03-10-15-05,2,449,428,21,271,210,157,11.428571428571429,10.420664206642066,9.78343949044586,0.7749077490774908,0.36682242990654207
06-01-480-30-10-03-10-15-05,3,484,462,22,277,222,185,11.878205128205128,10.169675090252708,10.994594594594595,0.8014440433212996,0.4004329004329004
06-01-480-30-10-03-10-15-05,4,497,475,22,273,227,202,12.424116424116423,10.307692307692308,11.242574257425742,0.8315018315018315,0.42526315789473684
06-01-480-30-10-03-10-15-05,5,493,471,22,279,207,192,11.40670859538784,10.078853046594983,10.447916666666666,0.7419354838709677,0.40764331210191085
06-01-480-30-10-03-10-15-05,6,494,471,23,286,226,185,12.064989517819706,9.916083916083917,10.864864864864865,0.7902097902097902,0.39278131634819535
06-01-480-30-10-03-10-15-05,7,472,450,22,289,201,161,11.432017543859649,9.71280276816609,10.819875776397515,0.6955017301038062,0.35777777777777775
06-01-480-30-10-03-10-15-05,8,473,459,14,278,213,181,11.89247311827957,10.18705035971223,11.099447513812155,0.7661870503597122,0.39433551198257083
06-01-480-30-10-03-10-15-05,9,506,489,17,286,217,203,11.57979797979798,9.94055944055944,10.714285714285714,0.7587412587412588,0.41513292433537835
06-01-480-30-10-03-10-15-05,10,539,505,34,292,228,213,11.620352250489237,9.75,10.821596244131456,0.7808219178082192,0.42178217821782177
06-01-480-30-10-03-10-15-05,11,465,453,12,285,184,168,11.145969498910675,9.912280701754385,10.672619047619047,0.6456140350877193,0.3708609271523179
06-01-480-30-10-03-10-15-05,12,448,433,15,285,204,148,11.200455580865604,9.891228070175439,10.263513513513514,0.7157894736842105,0.3418013856812933
06-01-480-30-10-03-10-15-05,13,466,453,13,282,190,171,11.257080610021786,10.0177304964539,10.614035087719298,0.6737588652482269,0.37748344370860926
06-01-480-30-10-03-10-15-05,14,515,499,16,285,206,214,12.233663366336634,9.926315789473684,11.462616822429906,0.7228070175438597,0.4288577154308617
06-01-480-30-10-03-10-15-05,15,475,460,15,280,220,180,12.126609442060087,10.028571428571428,11.36111111111111,0.7857142857142857,0.391304347826087
06-01-480-30-10-03-10-15-05,16,471,456,15,277,215,179,11.545454545454545,10.209386281588447,10.603351955307263,0.776173285198556,0.3925438596491228
06-01-480-30-10-03-10-15-05,17,466,448,18,290,231,158,11.865638766519824,9.786206896551723,10.930379746835444,0.7965517241379311,0.35267857142857145
06-01-480-30-10-03-10-15-05,18,472,453,19,289,209,164,11.472766884531591,9.71280276816609,10.335365853658537,0.7231833910034602,0.3620309050772627
06-01-480-30-10-03-10-15-05,19,452,441,11,277,201,164,11.272930648769576,10.140794223826715,10.707317073170731,0.7256317689530686,0.37188208616780044
06-01-480-30-10-03-10-15-05,20,478,456,22,290,213,166,11.837662337662337,9.806896551724138,11.180722891566266,0.7344827586206897,0.36403508771929827
06-01-480-30-10-03-10-15-05,21,455,441,14,289,192,152,11.082774049217003,9.716262975778546,10.427631578947368,0.6643598615916955,0.34467120181405897
06-01-480-30-10-03-10-15-05,22,468,451,17,277,220,174,12.083150984682714,10.220216606498195,11.091954022988507,0.7942238267148014,0.3858093126385809
06-01-480-30-10-03-10-15-05,23,481,453,28,280,210,173,11.542483660130719,10.057142857142857,10.375722543352602,0.75,0.3818984547461369
06-01-480-30-10-03-10-15-05,24,479,451,28,281,234,170,12.078774617067834,10.02846975088968,10.735294117647058,0.8327402135231317,0.376940133037694
06-01-480-30-10-03-10-15-05,25,470,457,13,286,227,171,12.114470842332613,9.856643356643357,11.222222222222221,0.7937062937062938,0.3741794310722101
06-01-480-30-10-03-10-15-05,26,506,487,19,287,232,200,12.04868154158215,9.797909407665506,11.16,0.8083623693379791,0.4106776180698152
06-01-480-30-10-03-10-15-05,27,454,440,14,280,178,160,10.57847533632287,10.1,10.11875,0.6357142857142857,0.36363636363636365
06-01-480-30-10-03-10-15-05,28,505,478,27,284,251,194,12.008264462809917,9.92605633802817,10.742268041237113,0.8838028169014085,0.40585774058577406
06-01-480-30-10-03-10-15-05,29,482,459,23,283,210,176,11.408602150537634,9.985865724381625,10.539772727272727,0.7420494699646644,0.38344226579520696
06-01-480-30-10-03-10-15-05,30,454,440,14,295,211,145,11.161434977578475,9.633898305084745,10.055172413793104,0.7152542372881356,0.32954545454545453
09-01-480-30-10-03-10-15-05,1,457,441,16,415,48,26,5.222222222222222,9.898795180722892,6.346153846153846,0.11566265060240964,0.05895691609977324
09-01-480-30-10-03-10-15-05,2,522,502,20,422,126,80,8.007827788649706,9.914691943127963,8.925,0.2985781990521327,0.1593625498007968
09-01-480-30-10-03-10-15-05,3,490,474,16,413,99,61,8.01656314699793,10.167070217917676,9.131147540983607,0.2397094430992736,0.12869198312236288
09-01-480-30-10-03-10-15-05,4,468,461,7,413,93,48,6.6581196581196584,9.854721549636803,8.416666666666666,0.22518159806295399,0.10412147505422993
09-01-480-30-10-03-10-15-05,5,481,464,17,426,46,38,5.289640591966173,9.77699530516432,7.657894736842105,0.107981220657277,0.08189655172413793
09-01-480-30-10-03-10-15-05,6,495,480,15,420,117,60,8.044989775051125,9.93095238095238,8.283333333333333,0.2785714285714286,0.125
09-01-480-30-10-03-10-15-05,7,480,468,12,424,76,44,7.035639412997903,9.86320754716981,8.159090909090908,0.1792452830188679,0.09401709401709402
09-01-480-30-10-03-10-15-05,8,463,444,19,423,33,21,4.735099337748345,9.687943262411348,7.571428571428571,0.07801418439716312,0.0472972972972973
09-01-480-30-10-03-10-15-05,9,491,480,11,422,99,58,7.703476482617587,9.898104265402843,8.568965517241379,0.23459715639810427,0.12083333333333333
09-01-480-30-10-03-10-15-05,10,502,474,28,415,70,59,7.229813664596273,10.048192771084338,7.694915254237288,0.1686746987951807,0.12447257383966245
09-01-480-30-10-03-10-15-05,11,450,437,13,396,66,41,6.452914798206278,10.11111111111111,8.21951219512195,0.16666666666666666,0.09382151029748284
09-01-480-30-10-03-10-15-05,12,496,473,23,427,48,46,6.535269709543568,9.92271662763466,6.695652173913044,0.11241217798594848,0.09725158562367865
09-01-480-30-10-03-10-15-05,13,468,463,5,410,70,53,6.935897435897436,10.017073170731708,7.566037735849057,0.17073170731707318,0.11447084233261338
09-01-480-30-10-03-10-15-05,14,483,456,27,415,52,41,5.823655913978494,10.142168674698794,8.048780487804878,0.12530120481927712,0.08991228070175439
09-01-480-30-10-03-10-15-05,15,459,449,10,417,63,32,5.554585152838428,10.035971223021583,8.28125,0.1510791366906475,0.07126948775055679
09-01-480-30-10-03-10-15-05,16,500,478,22,409,156,69,8.55441478439425,10.251833740831296,9.246376811594203,0.38141809290953543,0.14435146443514643
09-01-480-30-10-03-10-15-05,17,483,467,16,415,63,52,7.11344537815126,10.079518072289156,7.923076923076923,0.15180722891566265,0.11134903640256959
09-01-480-30-10-03-10-15-05,18,495,479,16,413,88,66,7.354508196721311,10.079903147699758,8.212121212121213,0.21307506053268765,0.13778705636743216
09-01-480-30-10-03-10-15-05,19,484,464,20,424,43,40,6.784355179704017,9.92688679245283,9.3,0.10141509433962265,0.08620689655172414
09-01-480-30-10-03-10-15-05,20,475,455,20,433,33,22,4.989224137931035,9.775981524249422,6.545454545454546,0.07621247113163972,0.04835164835164835
09-01-480-30-10-03-10-15-05,21,433,425,8,409,15,16,3.739030023094688,10.02444987775061,5.625,0.03667481662591687,0.03764705882352941
09-01-480-30-10-03-10-15-05,22,455,431,24,412,20,19,4.4795454545454545,9.895631067961165,5.631578947368421,0.04854368932038835,0.04408352668213457
09-01-480-30-10-03-10-15-05,23,510,492,18,415,151,77,8.550898203592814,10.185542168674699,8.142857142857142,0.363855421686747,0.1565040650406504
09-01-480-30-10-03-10-15-05,24,457,445,12,419,43,26,5.711453744493392,9.940334128878282,6.961538461538462,0.1026252983293556,0.058426966292134834
09-01-480-30-10-03-10-15-05,25,453,438,15,416,29,22,4.883668903803132,9.884615384615385,7.136363636363637,0.06971153846153846,0.0502283105022831
09-01-480-30-10-03-10-15-05,26,517,496,21,421,138,75,8.592079207920792,10.052256532066508,8.813333333333333,0.32779097387173395,0.15120967741935484
09-01-480-30-10-03-10-15-05,27,405,392,13,385,0,7,2.2044887780548628,10.057142857142857,4.285714285714286,0.0,0.017857142857142856
09-01-480-30-10-03-10-15-05,28,466,456,10,417,50,39,5.731182795698925,10.052757793764988,7.9743589743589745,0.11990407673860912,0.08552631578947369
09-01-480-30-10-03-10-15-05,29,497,480,17,417,100,63,8.188139059304703,10.13189448441247,7.333333333333333,0.23980815347721823,0.13125
09-01-480-30-10-03-10-15-05,30,477,447,30,410,67,37,6.135964912280702,9.9,7.54054054054054,0.16341463414634147,0.08277404921700224
12-01-480-30-10-03-10-15-05,1,465,457,8,456,0,1,0.8193548387096774,9.866228070175438,2.0,0.0,0.002188183807439825
12-01-480-30-10-03-10-15-05,2,492,482,10,481,0,1,0.7134146341463414,10.11018711018711,1.0,0.0,0.002074688796680498
12-01-480-30-10-03-10-15-05,3,470,465,5,461,0,4,0.7489361702127659,9.785249457700651,7.5,0.0,0.008602150537634409
12-01-480-30-10-03-10-15-05,4,459,448,11,448,0,0,0.6557734204793029,9.647321428571429,,0.0,0.0
12-01-480-30-10-03-10-15-05,5,480,474,6,470,2,4,1.2270833333333333,10.014893617021277,5.5,0.00425531914893617,0.008438818565400843
12-01-480-30-10-03-10-15-05,6,500,467,33,457,16,10,1.8204592901878915,9.982494529540482,4.8,0.0350109409190372,0.021413276231263382
12-01-480-30-10-03-10-15-05,7,540,530,10,519,20,11,2.5685185185185184,10.003853564547207,5.7272727272727275,0.038535645472061654,0.020754716981132074
12-01-480-30-10-03-10-15-05,8,478,469,9,469,0,0,0.6903765690376569,9.99360341151386,,0.0,0.0
12-01-480-30-10-03-10-15-05,9,464,452,12,451,0,1,0.790948275862069,10.172949002217296,5.0,0.0,0.0022123893805309734
12-01-480-30-10-03-10-15-05,10,504,486,18,482,0,4,1.2971887550200802,9.995850622406639,3.0,0.0,0.00823045267489712
12-01-480-30-10-03-10-15-05,11,465,461,4,461,0,0,0.8086021505376344,9.926247288503253,,0.0,0.0
12-01-480-30-10-03-10-15-05,12,467,449,18,448,0,1,0.6550976138828634,9.841517857142858,3.0,0.0,0.0022271714922048997
12-01-480-30-10-03-10-15-05,13,507,498,9,497,0,1,0.9625246548323472,9.83702213279678,4.0,0.0,0.002008032128514056
12-01-480-30-10-03-10-15-05,14,482,472,10,469,0,3,1.1950207468879668,10.110874200426439,4.0,0.0,0.006355932203389831
12-01-480-30-10-03-10-15-05,15,489,478,11,477,0,1,0.9815950920245399,9.972746331236896,1.0,0.0,0.0020920502092050207
12-01-480-30-10-03-10-15-05,16,501,487,14,486,0,1,1.4468937875751502,9.91358024691358,1.0,0.0,0.002053388090349076
12-01-480-30-10-03-10-15-05,17,464,452,12,448,3,4,1.269396551724138,9.84375,5.0,0.006696428571428571,0.008849557522123894
12-01-480-30-10-03-10-15-05,18,485,478,7,475,1,3,1.4804123711340207,10.178947368421053,2.6666666666666665,0.002105263157894737,0.006276150627615063
12-01-480-30-10-03-10-15-05,19,468,464,4,460,0,4,1.3162393162393162,10.008695652173913,4.75,0.0,0.008620689655172414
12-01-480-30-10-03-10-15-05,20,492,478,14,475,0,3,0.7612244897959184,9.974736842105264,2.6666666666666665,0.0,0.006276150627615063
12-01-480-30-10-03-10-15-05,21,489,484,5,482,0,2,1.2862985685071575,9.863070539419088,4.0,0.0,0.004132231404958678
12-01-480-30-10-03-10-15-05,22,448,441,7,441,0,0,0.3236607142857143,9.802721088435375,,0.0,0.0
12-01-480-30-10-03-10-15-05,23,461,448,13,446,0,2,0.6152173913043478,10.165919282511211,1.0,0.0,0.004464285714285714
12-01-480-30-10-03-10-15-05,24,488,479,9,478,0,1,0.6762295081967213,9.97489539748954,3.0,0.0,0.0020876826722338203
12-01-480-30-10-03-10-15-05,25,474,465,9,463,0,2,0.6708860759493671,9.807775377969762,3.0,0.0,0.004301075268817204
12-01-480-30-10-03-10-15-05,26,485,480,5,480,0,0,1.0556701030927835,10.047916666666667,,0.0,0.0
12-01-480-30-10-03-10-15-05,27,484,470,14,470,0,0,0.533195020746888,10.023404255319148,,0.0,0.0
12-01-480-30-10-03-10-15-05,28,474,467,7,459,24,8,2.0759493670886076,10.209150326797385,8.375,0.05228758169934641,0.017130620985010708
12-01-480-30-10-03-10-15-05,29,520,510,10,495,41,15,2.7903846153846152,10.06060606060606,9.4,0.08282828282828283,0.029411764705882353
12-01-480-30-10-03-10-15-05,30,496,486,10,481,6,5,1.9455645161290323,10.1995841995842,4.2,0.012474012474012475,0.0102880658436214
15-01-480-30-10-03-10-15-05,1,457,445,12,445,0,0,0.0700218818380744,9.90561797752809,,0.0,0.0
15-01-480-30-10-03-10-15-05,2,493,481,12,481,0,0,0.2231237322515213,10.085239085239085,,0.0,0.0
15-01-480-30-10-03-10-15-05,3,517,501,16,501,0,0,0.19767441860465115,9.842315369261478,,0.0,0.0
15-01-480-30-10-03-10-15-05,4,469,462,7,462,0,0,0.14498933901918976,10.064935064935066,,0.0,0.0
15-01-480-30-10-03-10-15-05,5,437,430,7,430,0,0,0.05263157894736842,9.867441860465116,,0.0,0.0
15-01-480-30-10-03-10-15-05,6,448,441,7,441,0,0,0.07366071428571429,10.002267573696145,,0.0,0.0
15-01-480-30-10-03-10-15-05,7,497,485,12,485,0,0,0.060362173038229376,9.89278350515464,,0.0,0.0
15-01-480-30-10-03-10-15-05,8,511,502,9,500,0,2,0.0958904109589041,9.944,1.0,0.0,0.00398406374501992
15-01-480-30-10-03-10-15-05,9,495,486,9,486,0,0,0.17373737373737375,10.026748971193415,,0.0,0.0
15-01-480-30-10-03-10-15-05,10,497,488,9,488,0,0,0.08450704225352113,9.723360655737705,,0.0,0.0
15-01-480-30-10-03-10-15-05,11,496,484,12,484,0,0,0.13911290322580644,9.993801652892563,,0.0,0.0
15-01-480-30-10-03-10-15-05,12,481,472,9,471,0,1,0.17463617463617465,10.019108280254777,1.0,0.0,0.00211864406779661
15-01-480-30-10-03-10-15-05,13,473,462,11,462,0,0,0.02959830866807611,9.906926406926408,,0.0,0.0
15-01-480-30-10-03-10-15-05,14,487,480,7,480,0,0,0.03490759753593429,9.995833333333334,,0.0,0.0
15-01-480-30-10-03-10-15-05,15,491,477,14,476,0,1,0.109979633401222,9.739495798319327,1.0,0.0,0.0020964360587002098
15-01-480-30-10-03-10-15-05,16,444,433,11,433,0,0,0.060810810810810814,9.891454965357967,,0.0,0.0
15-01-480-30-10-03-10-15-05,17,463,452,11,452,0,0,0.07991360691144708,9.891592920353983,,0.0,0.0
15-01-480-30-10-03-10-15-05,18,476,463,13,463,0,0,0.14915966386554622,9.922246220302377,,0.0,0.0
15-01-480-30-10-03-10-15-05,19,504,492,12,492,0,0,0.3392857142857143,9.971544715447154,,0.0,0.0
15-01-480-30-10-03-10-15-05,20,482,467,15,467,0,0,0.12033195020746888,9.970021413276232,,0.0,0.0
15-01-480-30-10-03-10-15-05,21,509,492,17,492,0,0,0.2879684418145957,9.973577235772357,,0.0,0.0
15-01-480-30-10-03-10-15-05,22,478,462,16,461,0,1,0.09853249475890985,9.92407809110629,1.0,0.0,0.0021645021645021645
15-01-480-30-10-03-10-15-05,23,521,513,8,513,0,0,0.6890595009596929,10.04093567251462,,0.0,0.0
15-01-480-30-10-03-10-15-05,24,483,475,8,475,0,0,0.07246376811594203,9.913684210526316,,0.0,0.0
15-01-480-30-10-03-10-15-05,25,475,468,7,468,0,0,0.07578947368421053,9.844017094017094,,0.0,0.0
15-01-480-30-10-03-10-15-05,26,434,422,12,422,0,0,0.018433179723502304,10.066350710900474,,0.0,0.0
15-01-480-30-10-03-10-15-05,27,444,435,9,435,0,0,0.0045045045045045045,9.735632183908047,,0.0,0.0
15-01-480-30-10-03-10-15-05,28,503,498,5,498,0,0,0.3976143141153082,9.963855421686747,,0.0,0.0
15-01-480-30-10-03-10-15-05,29,496,485,11,485,0,0,0.2862903225806452,9.997938144329897,,0.0,0.0
15-01-480-30-10-03-10-15-05,30,500,490,10,490,0,0,0.474,9.924489795918367,,0.0,0.0
18-01-480-30-10-03-10-15-05,1,475,464,11,463,0,1,0.04842105263157895,9.969762419006479,1.0,0.0,0.0021551724137931034
18-01-480-30-10-03-10-15-05,2,493,479,14,479,0,0,0.004056795131845842,10.029227557411273,,0.0,0.0
18-01-480-30-10-03-10-15-05,3,479,468,11,468,0,0,0.08559498956158663,9.991452991452991,,0.0,0.0
18-01-480-30-10-03-10-15-05,4,509,501,8,501,0,0,0.04911591355599214,10.059880239520957,,0.0,0.0
18-01-480-30-10-03-10-15-05,5,457,453,4,453,0,0,0.002188183807439825,10.097130242825607,,0.0,0.0
18-01-480-30-10-03-10-15-05,6,507,496,11,496,0,0,0.0039447731755424065,10.296370967741936,,0.0,0.0
18-01-480-30-10-03-10-15-05,7,508,497,11,497,0,0,0.017716535433070866,9.790744466800804,,0.0,0.0
18-01-480-30-10-03-10-15-05,8,502,495,7,495,0,0,0.09163346613545817,9.88888888888889,,0.0,0.0
18-01-480-30-10-03-10-15-05,9,444,439,5,439,0,0,0.0,9.913439635535308,,0.0,0.0
18-01-480-30-10-03-10-15-05,10,482,478,4,478,0,0,0.0912863070539419,10.07949790794979,,0.0,0.0
18-01-480-30-10-03-10-15-05,11,443,429,14,429,0,0,0.0,10.06993006993007,,0.0,0.0
18-01-480-30-10-03-10-15-05,12,480,468,12,468,0,0,0.18333333333333332,10.061965811965813,,0.0,0.0
18-01-480-30-10-03-10-15-05,13,467,453,14,453,0,0,0.019271948608137045,10.068432671081677,,0.0,0.0
18-01-480-30-10-03-10-15-05,14,457,453,4,453,0,0,0.0,9.79690949227373,,0.0,0.0
18-01-480-30-10-03-10-15-05,15,506,493,13,493,0,0,0.009881422924901186,9.63894523326572,,0.0,0.0
18-01-480-30-10-03-10-15-05,16,491,479,12,479,0,0,0.028513238289205704,10.24634655532359,,0.0,0.0
18-01-480-30-10-03-10-15-05,17,447,439,8,439,0,0,0.0022371364653243847,9.995444191343964,,0.0,0.0
18-01-480-30-10-03-10-15-05,18,474,461,13,461,0,0,0.0,9.887201735357918,,0.0,0.0
18-01-480-30-10-03-10-15-05,19,449,437,12,437,0,0,0.0022271714922048997,9.99771167048055,,0.0,0.0
18-01-480-30-10-03-10-15-05,20,484,475,9,475,0,0,0.006198347107438017,9.894736842105264,,0.0,0.0
18-01-480-30-10-03-10-15-05,21,514,502,12,501,0,1,0.029182879377431907,10.037924151696608,1.0,0.0,0.00199203187250996
18-01-480-30-10-03-10-15-05,22,495,482,13,482,0,0,0.03232323232323232,10.228215767634854,,0.0,0.0
18-01-480-30-10-03-10-15-05,23,469,460,9,460,0,0,0.0,10.013043478260869,,0.0,0.0
18-01-480-30-10-03-10-15-05,24,466,460,6,460,0,0,0.0,9.560869565217391,,0.0,0.0
18-01-480-30-10-03-10-15-05,25,465,452,13,452,0,0,0.01935483870967742,10.121681415929203,,0.0,0.0
18-01-480-30-10-03-10-15-05,26,471,460,11,460,0,0,0.03821656050955414,9.85,,0.0,0.0
18-01-480-30-10-03-10-15-05,27,457,448,9,448,0,0,0.0262582056892779,10.080357142857142,,0.0,0.0
18-01-480-30-10-03-10-15-05,28,503,497,6,497,0,0,0.009940357852882704,9.778672032193159,,0.0,0.0
18-01-480-30-10-03-10-15-05,29,453,442,11,442,0,0,0.008830022075055188,9.880090497737557,,0.0,0.0
18-01-480-30-10-03-10-15-05,30,512,503,9,503,0,0,0.009765625,9.739562624254473,,0.0,0.0
21-01-480-30-10-03-10-15-05,1,505,490,15,490,0,0,0.0,9.944897959183674,,0.0,0.0
21-01-480-30-10-03-10-15-05,2,455,452,3,452,0,0,0.0,9.752212389380531,,0.0,0.0
21-01-480-30-10-03-10-15-05,3,439,428,11,428,0,0,0.004555808656036446,10.065420560747663,,0.0,0.0
21-01-480-30-10-03-10-15-05,4,499,493,6,493,0,0,0.002004008016032064,9.651115618661258,,0.0,0.0
21-01-480-30-10-03-10-15-05,5,459,449,10,449,0,0,0.030501089324618737,9.926503340757238,,0.0,0.0
21-01-480-30-10-03-10-15-05,6,454,447,7,447,0,0,0.0,9.870246085011185,,0.0,0.0
21-01-480-30-10-03-10-15-05,7,466,448,18,448,0,0,0.0,9.821428571428571,,0.0,0.0
21-01-480-30-10-03-10-15-05,8,492,485,7,485,0,0,0.0,9.975257731958763,,0.0,0.0
21-01-480-30-10-03-10-15-05,9,496,488,8,488,0,0,0.0,10.133196721311476,,0.0,0.0
21-01-480-30-10-03-10-15-05,10,480,469,11,469,0,0,0.0,9.963752665245202,,0.0,0.0
21-01-480-30-10-03-10-15-05,11,476,462,14,462,0,0,0.0,9.945887445887445,,0.0,0.0
21-01-480-30-10-03-10-15-05,12,491,483,8,483,0,0,0.0,10.138716356107661,,0.0,0.0
21-01-480-30-10-03-10-15-05,13,550,540,10,540,0,0,0.01818181818181818,9.925925925925926,,0.0,0.0
21-01-480-30-10-03-10-15-05,14,474,462,12,462,0,0,0.0,10.14935064935065,,0.0,0.0
21-01-480-30-10-03-10-15-05,15,494,487,7,487,0,0,0.004048582995951417,9.763860369609857,,0.0,0.0
21-01-480-30-10-03-10-15-05,16,466,460,6,460,0,0,0.02575107296137339,10.110869565217392,,0.0,0.0
21-01-480-30-10-03-10-15-05,17,470,460,10,460,0,0,0.00851063829787234,9.769565217391305,,0.0,0.0
21-01-480-30-10-03-10-15-05,18,467,454,13,454,0,0,0.0,9.786343612334802,,0.0,0.0
21-01-480-30-10-03-10-15-05,19,499,479,20,479,0,0,0.002004008016032064,10.127348643006263,,0.0,0.0
21-01-480-30-10-03-10-15-05,20,485,477,8,477,0,0,0.0,10.067085953878406,,0.0,0.0
21-01-480-30-10-03-10-15-05,21,436,424,12,424,0,0,0.0,10.040094339622641,,0.0,0.0
21-01-480-30-10-03-10-15-05,22,488,476,12,476,0,0,0.0,9.947478991596638,,0.0,0.0
21-01-480-30-10-03-10-15-05,23,506,501,5,501,0,0,0.0,10.039920159680639,,0.0,0.0
21-01-480-30-10-03-10-15-05,24,489,478,11,478,0,0,0.002044989775051125,9.912133891213388,,0.0,0.0
21-01-480-30-10-03-10-15-05,25,476,468,8,468,0,0,0.0,9.867521367521368,,0.0,0.0
21-01-480-30-10-03-10-15-05,26,509,500,9,500,0,0,0.03536345776031434,9.718,,0.0,0.0
21-01-480-30-10-03-10-15-05,27,477,467,10,467,0,0,0.0,10.068522483940043,,0.0,0.0
21-01-480-30-10-03-10-15-05,28,505,495,10,495,0,0,0.0,9.834343434343435,,0.0,0.0
21-01-480-30-10-03-10-15-05,29,469,463,6,463,0,0,0.0,9.794816414686824,,0.0,0.0
21-01-480-30-10-03-10-15-05,30,463,455,8,455,0,0,0.0,9.936263736263736,,0.0,0.0
24-01-480-30-10-03-10-15-05,1,493,480,13,480,0,0,0.0,9.95625,,0.0,0.0
24-01-480-30-10-03-10-15-05,2,497,479,18,479,0,0,0.0,10.11482254697286,,0.0,0.0
24-01-480-30-10-03-10-15-05,3,506,496,10,496,0,0,0.0,10.211693548387096,,0.0,0.0
24-01-480-30-10-03-10-15-05,4,449,442,7,442,0,0,0.0,9.832579185520363,,0.0,0.0
24-01-480-30-10-03-10-15-05,5,489,476,13,476,0,0,0.0,10.09873949579832,,0.0,0.0
24-01-480-30-10-03-10-15-05,6,504,499,5,499,0,0,0.0,9.98196392785571,,0.0,0.0
24-01-480-30-10-03-10-15-05,7,529,515,14,515,0,0,0.0831758034026465,10.007766990291262,,0.0,0.0
24-01-480-30-10-03-10-15-05,8,476,466,10,466,0,0,0.0,9.96351931330472,,0.0,0.0
24-01-480-30-10-03-10-15-05,9,490,481,9,481,0,0,0.0,10.120582120582121,,0.0,0.0
24-01-480-30-10-03-10-15-05,10,503,496,7,496,0,0,0.0,10.201612903225806,,0.0,0.0
24-01-480-30-10-03-10-15-05,11,512,498,14,498,0,0,0.0,10.24698795180723,,0.0,0.0
24-01-480-30-10-03-10-15-05,12,488,480,8,480,0,0,0.0020491803278688526,9.64375,,0.0,0.0
24-01-480-30-10-03-10-15-05,13,486,475,11,475,0,0,0.0,10.042105263157895,,0.0,0.0
24-01-480-30-10-03-10-15-05,14,500,490,10,490,0,0,0.0,10.083673469387755,,0.0,0.0
24-01-480-30-10-03-10-15-05,15,477,468,9,468,0,0,0.0,9.85897435897436,,0.0,0.0
24-01-480-30-10-03-10-15-05,16,481,472,9,472,0,0,0.0,9.773305084745763,,0.0,0.0
24-01-480-30-10-03-10-15-05,17,506,495,11,495,0,0,0.0,10.05050505050505,,0.0,0.0
24-01-480-30-10-03-10-15-05,18,501,493,8,493,0,0,0.0,10.075050709939148,,0.0,0.0
24-01-480-30-10-03-10-15-05,19,494,488,6,488,0,0,0.0,9.932377049180328,,0.0,0.0
24-01-480-30-10-03-10-15-05,20,506,496,10,496,0,0,0.0,9.879032258064516,,0.0,0.0
24-01-480-30-10-03-10-15-05,21,468,457,11,457,0,0,0.0,10.339168490153172,,0.0,0.0
24-01-480-30-10-03-10-15-05,22,496,486,10,486,0,0,0.0020161290322580645,10.061728395061728,,0.0,0.0
24-01-480-30-10-03-10-15-05,23,471,454,17,454,0,0,0.0,10.1431718061674,,0.0,0.0
24-01-480-30-10-03-10-15-05,24,476,469,7,469,0,0,0.0,9.816631130063966,,0.0,0.0
24-01-480-30-10-03-10-15-05,25,479,472,7,472,0,0,0.0,9.942796610169491,,0.0,0.0
24-01-480-30-10-03-10-15-05,26,561,545,16,545,0,0,0.0142602495543672,9.844036697247706,,0.0,0.0
24-01-480-30-10-03-10-15-05,27,465,456,9,456,0,0,0.004301075268817204,10.06578947368421,,0.0,0.0
24-01-480-30-10-03-10-15-05,28,460,451,9,451,0,0,0.0,10.06430155210643,,0.0,0.0
24-01-480-30-10-03-10-15-05,29,445,438,7,438,0,0,0.0,9.979452054794521,,0.0,0.0
24-01-480-30-10-03-10-15-05,30,464,454,10,454,0,0,0.0,10.088105726872246,,0.0,0.0
27-01-480-30-10-03-10-15-05,1,485,472,13,472,0,0,0.0,10.091101694915254,,0.0,0.0
27-01-480-30-10-03-10-15-05,2,441,435,6,435,0,0,0.0,9.891954022988505,,0.0,0.0
27-01-480-30-10-03-10-15-05,3,497,478,19,478,0,0,0.0,10.031380753138075,,0.0,0.0
27-01-480-30-10-03-10-15-05,4,479,472,7,472,0,0,0.0,9.953389830508474,,0.0,0.0
27-01-480-30-10-03-10-15-05,5,468,458,10,458,0,0,0.0,10.034934497816593,,0.0,0.0
27-01-480-30-10-03-10-15-05,6,509,499,10,499,0,0,0.0,9.705410821643287,,0.0,0.0
27-01-480-30-10-03-10-15-05,7,508,496,12,496,0,0,0.0,9.596774193548388,,0.0,0.0
27-01-480-30-10-03-10-15-05,8,507,498,9,498,0,0,0.0,10.02008032128514,,0.0,0.0
27-01-480-30-10-03-10-15-05,9,465,455,10,455,0,0,0.0,9.918681318681319,,0.0,0.0
27-01-480-30-10-03-10-15-05,10,524,498,26,498,0,0,0.0,10.156626506024097,,0.0,0.0
27-01-480-30-10-03-10-15-05,11,473,465,8,465,0,0,0.0,10.03010752688172,,0.0,0.0
27-01-480-30-10-03-10-15-05,12,479,465,14,465,0,0,0.0,9.858064516129032,,0.0,0.0
27-01-480-30-10-03-10-15-05,13,482,470,12,470,0,0,0.0,10.142553191489363,,0.0,0.0
27-01-480-30-10-03-10-15-05,14,488,478,10,478,0,0,0.0,10.02510460251046,,0.0,0.0
27-01-480-30-10-03-10-15-05,15,480,475,5,475,0,0,0.0,9.930526315789473,,0.0,0.0
27-01-480-30-10-03-10-15-05,16,456,449,7,449,0,0,0.0,10.080178173719377,,0.0,0.0
27-01-480-30-10-03-10-15-05,17,513,502,11,502,0,0,0.0,10.04382470119522,,0.0,0.0
27-01-480-30-10-03-10-15-05,18,454,445,9,445,0,0,0.0,10.182022471910113,,0.0,0.0
27-01-480-30-10-03-10-15-05,19,498,489,9,489,0,0,0.0,9.848670756646216,,0.0,0.0
27-01-480-30-10-03-10-15-05,20,533,515,18,515,0,0,0.0,10.040776699029125,,0.0,0.0
27-01-480-30-10-03-10-15-05,21,472,460,12,460,0,0,0.0,9.695652173913043,,0.0,0.0
27-01-480-30-10-03-10-15-05,22,464,458,6,458,0,0,0.0,10.102620087336245,,0.0,0.0
27-01-480-30-10-03-10-15-05,23,513,502,11,502,0,0,0.0,10.0597609561753,,0.0,0.0
27-01-480-30-10-03-10-15-05,24,475,466,9,466,0,0,0.0,10.034334763948499,,0.0,0.0
27-01-480-30-10-03-10-15-05,25,456,451,5,451,0,0,0.0,9.829268292682928,,0.0,0.0
27-01-480-30-10-03-10-15-05,26,484,475,9,475,0,0,0.0,10.031578947368422,,0.0,0.0
27-01-480-30-10-03-10-15-05,27,470,458,12,458,0,0,0.0,10.15065502183406,,0.0,0.0
27-01-480-30-10-03-10-15-05,28,469,462,7,462,0,0,0.0,9.95021645021645,,0.0,0.0
27-01-480-30-10-03-10-15-05,29,507,498,9,498,0,0,0.0,10.146586345381525,,0.0,0.0
27-01-480-30-10-03-10-15-05,30,464,452,12,452,0,0,0.0,9.922566371681416,,0.0,0.0
30-01-480-30-10-03-10-15-05,1,484,472,12,472,0,0,0.0,9.745762711864407,,0.0,0.0
30-01-480-30-10-03-10-15-05,2,447,431,16,431,0,0,0.0,10.011600928074246,,0.0,0.0
30-01-480-30-10-03-10-15-05,3,491,482,9,482,0,0,0.0,9.863070539419088,,0.0,0.0
30-01-480-30-10-03-10-15-05,4,479,467,12,467,0,0,0.0,10.261241970021413,,0.0,0.0
30-01-480-30-10-03-10-15-05,5,499,489,10,489,0,0,0.0,9.991820040899796,,0.0,0.0
30-01-480-30-10-03-10-15-05,6,483,468,15,468,0,0,0.0,9.705128205128204,,0.0,0.0
30-01-480-30-10-03-10-15-05,7,468,458,10,458,0,0,0.0,9.906113537117903,,0.0,0.0
30-01-480-30-10-03-10-15-05,8,469,460,9,460,0,0,0.0,10.030434782608696,,0.0,0.0
30-01-480-30-10-03-10-15-05,9,447,439,8,439,0,0,0.0,10.059225512528474,,0.0,0.0
30-01-480-30-10-03-10-15-05,10,485,477,8,477,0,0,0.0,10.064989517819706,,0.0,0.0
30-01-480-30-10-03-10-15-05,11,469,463,6,463,0,0,0.0,10.177105831533478,,0.0,0.0
30-01-480-30-10-03-10-15-05,12,487,473,14,473,0,0,0.0,10.046511627906977,,0.0,0.0
30-01-480-30-10-03-10-15-05,13,500,489,11,489,0,0,0.0,10.004089979550102,,0.0,0.0
30-01-480-30-10-03-10-15-05,14,456,451,5,451,0,0,0.0,9.902439024390244,,0.0,0.0
30-01-480-30-10-03-10-15-05,15,475,464,11,464,0,0,0.0,10.267241379310345,,0.0,0.0
30-01-480-30-10-03-10-15-05,16,498,489,9,489,0,0,0.0,10.130879345603272,,0.0,0.0
30-01-480-30-10-03-10-15-05,17,479,471,8,471,0,0,0.0,10.0,,0.0,0.0
30-01-480-30-10-03-10-15-05,18,473,463,10,463,0,0,0.0,10.051835853131749,,0.0,0.0
30-01-480-30-10-03-10-15-05,19,461,452,9,452,0,0,0.0,9.904867256637168,,0.0,0.0
30-01-480-30-10-03-10-15-05,20,455,442,13,442,0,0,0.0,10.113122171945701,,0.0,0.0
30-01-480-30-10-03-10-15-05,21,503,490,13,490,0,0,0.0,9.906122448979591,,0.0,0.0
30-01-480-30-10-03-10-15-05,22,442,433,9,433,0,0,0.0,10.221709006928407,,0.0,0.0
30-01-480-30-10-03-10-15-05,23,506,495,11,495,0,0,0.0,10.066666666666666,,0.0,0.0
30-01-480-30-10-03-10-15-05,24,469,460,9,460,0,0,0.0,9.91304347826087,,0.0,0.0
30-01-480-30-10-03-10-15-05,25,486,473,13,473,0,0,0.0,9.932346723044397,,0.0,0.0
30-01-480-30-10-03-10-15-05,26,457,442,15,442,0,0,0.0,10.108597285067873,,0.0,0.0
30-01-480-30-10-03-10-15-05,27,444,436,8,436,0,0,0.0,9.823394495412844,,0.0,0.0
30-01-480-30-10-03-10-15-05,28,496,477,19,477,0,0,0.0,10.033542976939204,,0.0,0.0
30-01-480-30-10-03-10-15-05,29,504,491,13,491,0,0,0.0,10.189409368635438,,0.0,0.0
30-01-480-30-10-03-10-15-05,30,451,444,7,444,0,0,0.0,10.193693693693694,,0.0,0.0
03-02-480-30-10-03-10-15-05,1,1000,957,43,139,136,818,14.651041666666666,10.251798561151078,14.030562347188264,0.9784172661870504,0.8547544409613375
03-02-480-30-10-03-10-15-05,2,979,911,68,146,143,765,14.602844638949671,9.698630136986301,13.87843137254902,0.9794520547945206,0.8397365532381997
03-02-480-30-10-03-10-15-05,3,917,866,51,136,133,730,14.466052934407365,10.411764705882353,13.804109589041095,0.9779411764705882,0.8429561200923787
03-02-480-30-10-03-10-15-05,4,958,901,57,139,136,762,14.817477876106194,10.086330935251798,14.034120734908136,0.9784172661870504,0.8457269700332963
03-02-480-30-10-03-10-15-05,5,923,881,42,141,138,740,14.610859728506787,10.02836879432624,13.887837837837838,0.9787234042553191,0.8399545970488081
03-02-480-30-10-03-10-15-05,6,990,946,44,142,138,804,14.324552160168599,9.929577464788732,13.640547263681592,0.971830985915493,0.8498942917547568
03-02-480-30-10-03-10-15-05,7,871,826,45,140,137,686,14.281061519903497,10.121428571428572,13.510204081632653,0.9785714285714285,0.8305084745762712
03-02-480-30-10-03-10-15-05,8,959,912,47,142,139,770,14.069945355191257,10.014084507042254,13.393506493506493,0.9788732394366197,0.8442982456140351
03-02-480-30-10-03-10-15-05,9,957,919,38,146,146,773,14.314533622559653,9.719178082191782,13.548512289780078,1.0,0.8411316648531012
03-02-480-30-10-03-10-15-05,10,979,926,53,140,136,786,14.469321851453175,10.028571428571428,13.756997455470739,0.9714285714285714,0.8488120950323974
03-02-480-30-10-03-10-15-05,11,1008,942,66,143,142,799,14.425396825396826,9.979020979020978,13.737171464330412,0.993006993006993,0.8481953290870489
03-02-480-30-10-03-10-15-05,12,1060,993,67,142,140,851,14.491967871485944,9.922535211267606,13.796709753231493,0.9859154929577465,0.8569989929506546
03-02-480-30-10-03-10-15-05,13,1057,989,68,141,139,848,14.352822580645162,10.092198581560284,13.653301886792454,0.9858156028368794,0.8574317492416582
03-02-480-30-10-03-10-15-05,14,916,863,53,141,139,722,14.623556581986143,10.120567375886525,13.943213296398891,0.9858156028368794,0.8366164542294322
03-02-480-30-10-03-10-15-05,15,946,903,43,139,136,764,14.647902869757175,10.215827338129497,13.926701570680628,0.9784172661870504,0.8460686600221484
03-02-480-30-10-03-10-15-05,16,989,947,42,145,142,802,14.552631578947368,9.8,13.78927680798005,0.9793103448275862,0.8468848996832101
03-02-480-30-10-03-10-15-05,17,961,921,40,144,141,777,14.557359307359308,9.875,13.83011583011583,0.9791666666666666,0.8436482084690554
03-02-480-30-10-03-10-15-05,18,982,931,51,142,141,789,14.714132762312634,9.950704225352112,13.982256020278834,0.9929577464788732,0.8474758324382384
03-02-480-30-10-03-10-15-05,19,902,856,46,139,136,717,14.70663562281723,10.223021582733812,13.93723849372385,0.9784172661870504,0.8376168224299065
03-02-480-30-10-03-10-15-05,20,1018,967,51,139,136,828,14.585567010309278,10.20863309352518,13.991545893719806,0.9784172661870504,0.8562564632885212
03-02-480-30-10-03-10-15-05,21,964,908,56,144,142,764,14.594950603732162,9.916666666666666,13.803664921465968,0.9861111111111112,0.8414096916299559
03-02-480-30-10-03-10-15-05,22,934,879,55,144,141,735,14.545351473922903,9.805555555555555,13.806802721088435,0.9791666666666666,0.8361774744027304
03-02-480-30-10-03-10-15-05,23,900,872,28,141,137,731,14.612571428571428,10.113475177304965,13.878248974008208,0.9716312056737588,0.838302752293578
03-02-480-30-10-03-10-15-05,24,938,879,59,145,143,734,14.595238095238095,9.717241379310344,13.739782016348775,0.9862068965517241,0.8350398179749715
03-02-480-30-10-03-10-15-05,25,953,894,59,144,142,750,14.39241917502787,9.833333333333334,13.608,0.9861111111111112,0.8389261744966443
03-02-480-30-10-03-10-15-05,26,918,874,44,145,141,729,14.55872291904219,9.786206896551723,13.82716049382716,0.9724137931034482,0.834096109839817
03-02-480-30-10-03-10-15-05,27,956,914,42,147,144,767,14.59651035986914,9.578231292517007,13.920469361147328,0.9795918367346939,0.8391684901531729
03-02-480-30-10-03-10-15-05,28,943,909,34,145,142,764,14.739035087719298,9.813793103448276,14.1282722513089,0.9793103448275862,0.8404840484048405
03-02-480-30-10-03-10-15-05,29,956,911,45,146,141,765,14.263676148796499,9.753424657534246,13.473202614379085,0.9657534246575342,0.8397365532381997
03-02-480-30-10-03-10-15-05,30,1004,939,65,142,138,797,14.687898089171975,9.894366197183098,13.959849435382685,0.971830985915493,0.8487752928647497
06-02-480-30-10-03-10-15-05,1,893,846,47,280,273,566,13.82981220657277,10.121428571428572,12.602473498233216,0.975,0.6690307328605201
06-02-480-30-10-03-10-15-05,2,968,931,37,283,276,648,13.862326574172892,10.049469964664311,12.700617283950617,0.9752650176678446,0.6960257787325457
06-02-480-30-10-03-10-15-05,3,960,911,49,289,279,622,13.70774263904035,9.823529411764707,12.554662379421222,0.9653979238754326,0.6827661909989023
06-02-480-30-10-03-10-15-05,4,947,910,37,282,267,628,13.463973799126638,9.9822695035461,12.455414012738853,0.9468085106382979,0.6901098901098901
06-02-480-30-10-03-10-15-05,5,904,851,53,277,268,574,13.624270711785298,10.191335740072201,12.54006968641115,0.9675090252707581,0.6745005875440658
06-02-480-30-10-03-10-15-05,6,906,879,27,287,281,592,13.613559322033899,9.878048780487806,12.41722972972973,0.9790940766550522,0.6734926052332195
06-02-480-30-10-03-10-15-05,7,977,935,42,283,278,652,13.804463336875664,10.017667844522968,12.67638036809816,0.9823321554770318,0.6973262032085561
06-02-480-30-10-03-10-15-05,8,914,869,45,281,275,588,13.624,10.1067615658363,12.539115646258503,0.9786476868327402,0.6766398158803222
06-02-480-30-10-03-10-15-05,9,954,888,66,281,272,607,14.026845637583893,10.117437722419929,12.831960461285009,0.9679715302491103,0.6835585585585585
06-02-480-30-10-03-10-15-05,10,922,885,37,282,275,603,14.075196408529742,10.117021276595745,12.862354892205639,0.975177304964539,0.6813559322033899
06-02-480-30-10-03-10-15-05,11,974,952,22,285,279,667,13.902922755741127,9.996491228070175,12.766116941529235,0.9789473684210527,0.7006302521008403
06-02-480-30-10-03-10-15-05,12,998,954,44,281,273,673,13.808333333333334,10.06049822064057,12.772659732540863,0.9715302491103203,0.7054507337526206
06-02-480-30-10-03-10-15-05,13,959,929,30,277,266,652,13.837433155080214,10.129963898916968,12.789877300613497,0.9602888086642599,0.7018299246501615
06-02-480-30-10-03-10-15-05,14,1014,965,49,280,271,685,14.036045314109165,10.096428571428572,12.836496350364964,0.9678571428571429,0.7098445595854922
06-02-480-30-10-03-10-15-05,15,949,913,36,285,279,628,13.817192600652884,9.926315789473684,12.503184713375797,0.9789473684210527,0.687842278203724
06-02-480-30-10-03-10-15-05,16,926,904,22,286,274,618,13.551648351648351,9.902097902097902,12.498381877022654,0.958041958041958,0.6836283185840708
06-02-480-30-10-03-10-15-05,17,1050,1012,38,284,277,728,13.762278978388998,9.950704225352112,12.651098901098901,0.9753521126760564,0.7193675889328063
06-02-480-30-10-03-10-15-05,18,940,911,29,281,276,630,13.63576881134133,10.117437722419929,12.455555555555556,0.9822064056939501,0.6915477497255763
06-02-480-30-10-03-10-15-05,19,949,898,51,286,276,612,13.769911504424778,9.884615384615385,12.606209150326798,0.965034965034965,0.6815144766146993
06-02-480-30-10-03-10-15-05,20,935,905,30,276,270,629,14.012074643249177,10.31159420289855,12.833068362480127,0.9782608695652174,0.6950276243093922
06-02-480-30-10-03-10-15-05,21,1014,986,28,277,268,709,14.161290322580646,10.256317689530686,13.059238363892806,0.9675090252707581,0.7190669371196755
06-02-480-30-10-03-10-15-05,22,916,888,28,290,281,598,13.521252796420582,9.813793103448276,12.536789297658864,0.9689655172413794,0.6734234234234234
06-02-480-30-10-03-10-15-05,23,984,945,39,284,273,661,14.021030494216614,9.929577464788732,12.913767019667171,0.9612676056338029,0.6994708994708995
06-02-480-30-10-03-10-15-05,24,915,884,31,278,268,606,13.813483146067416,10.154676258992806,12.73927392739274,0.9640287769784173,0.6855203619909502
06-02-480-30-10-03-10-15-05,25,955,905,50,287,278,618,13.649835345773875,9.801393728222996,12.522653721682849,0.9686411149825784,0.6828729281767956
06-02-480-30-10-03-10-15-05,26,963,930,33,291,284,639,13.814102564102564,9.786941580756015,12.708920187793428,0.9759450171821306,0.6870967741935484
06-02-480-30-10-03-10-15-05,27,938,897,41,285,274,612,13.858250276854928,9.95438596491228,12.84640522875817,0.9614035087719298,0.6822742474916388
06-02-480-30-10-03-10-15-05,28,965,918,47,287,282,631,13.972943722943723,9.843205574912892,12.767036450079239,0.9825783972125436,0.6873638344226579
06-02-480-30-10-03-10-15-05,29,935,881,54,287,279,594,13.872604284103721,9.871080139372822,12.702020202020202,0.9721254355400697,0.674233825198638
06-02-480-30-10-03-10-15-05,30,895,867,28,282,274,585,13.950744558991982,10.056737588652481,12.810256410256411,0.9716312056737588,0.6747404844290658
09-02-480-30-10-03-10-15-05,1,947,913,34,431,404,482,13.189804772234273,9.863109048723897,11.99792531120332,0.9373549883990719,0.5279299014238773
09-02-480-30-10-03-10-15-05,2,990,940,50,427,404,513,13.184404636459432,9.896955503512881,11.674463937621832,0.9461358313817331,0.5457446808510639
09-02-480-30-10-03-10-15-05,3,896,871,25,420,387,451,12.951136363636364,10.088095238095239,11.709534368070953,0.9214285714285714,0.5177956371986223
09-02-480-30-10-03-10-15-05,4,894,863,31,427,402,436,12.872706422018348,9.90632318501171,11.403669724770642,0.9414519906323185,0.5052143684820394
09-02-480-30-10-03-10-15-05,5,904,862,42,421,392,441,12.77841561423651,10.05938242280285,11.73015873015873,0.9311163895486936,0.511600928074246
09-02-480-30-10-03-10-15-05,6,942,913,29,423,382,490,12.658351409978309,10.049645390070921,11.424489795918367,0.9030732860520094,0.5366922234392114
09-02-480-30-10-03-10-15-05,7,999,972,27,437,421,535,13.26197757390418,9.750572082379863,11.829906542056074,0.9633867276887872,0.5504115226337448
09-02-480-30-10-03-10-15-05,8,832,799,33,427,372,372,12.615099009900991,9.957845433255269,11.46774193548387,0.8711943793911007,0.4655819774718398
09-02-480-30-10-03-10-15-05,9,1012,969,43,432,403,537,12.98364008179959,9.868055555555555,11.752327746741155,0.9328703703703703,0.5541795665634675
09-02-480-30-10-03-10-15-05,10,968,937,31,427,402,510,12.987315010570825,9.969555035128806,11.531372549019608,0.9414519906323185,0.544290288153682
09-02-480-30-10-03-10-15-05,11,906,857,49,418,398,439,13.01039260969977,10.181818181818182,11.633257403189067,0.9521531100478469,0.5122520420070011
09-02-480-30-10-03-10-15-05,12,942,904,38,436,410,468,12.974808324205915,9.690366972477063,11.58974358974359,0.9403669724770642,0.5176991150442478
09-02-480-30-10-03-10-15-05,13,936,896,40,424,389,472,13.229834254143647,10.0,12.076271186440678,0.9174528301886793,0.5267857142857143
09-02-480-30-10-03-10-15-05,14,1052,1001,51,423,405,578,13.547524752475248,9.988179669030734,12.126297577854672,0.9574468085106383,0.5774225774225774
09-02-480-30-10-03-10-15-05,15,920,888,32,416,368,472,13.139353400222966,10.1875,11.851694915254237,0.8846153846153846,0.5315315315315315
09-02-480-30-10-03-10-15-05,16,925,892,33,420,398,472,12.913429522752498,10.166666666666666,11.444915254237289,0.9476190476190476,0.5291479820627802
09-02-480-30-10-03-10-15-05,17,951,900,51,423,388,477,13.124312431243125,10.0,11.90775681341719,0.91725768321513,0.53
09-02-480-30-10-03-10-15-05,18,986,941,45,418,386,523,13.446315789473685,10.188995215311005,12.252390057361376,0.9234449760765551,0.5557917109458024
09-02-480-30-10-03-10-15-05,19,916,873,43,420,399,453,13.2437641723356,10.021428571428572,11.900662251655628,0.95,0.5189003436426117
09-02-480-30-10-03-10-15-05,20,987,948,39,416,402,532,13.29153605015674,10.185096153846153,11.87781954887218,0.9663461538461539,0.5611814345991561
09-02-480-30-10-03-10-15-05,21,957,896,61,424,406,472,12.806629834254144,9.997641509433961,11.438559322033898,0.9575471698113207,0.5267857142857143
09-02-480-30-10-03-10-15-05,22,952,909,43,417,388,492,13.098039215686274,10.194244604316546,11.644308943089431,0.9304556354916067,0.5412541254125413
09-02-480-30-10-03-10-15-05,23,1036,984,52,428,405,556,13.216515609264855,9.948598130841122,11.929856115107913,0.9462616822429907,0.5650406504065041
09-02-480-30-10-03-10-15-05,24,892,869,23,422,398,447,12.632118451025057,10.056872037914692,11.266219239373601,0.943127962085308,0.5143843498273878
09-02-480-30-10-03-10-15-05,25,920,878,42,420,390,458,12.631341600901916,10.09047619047619,11.283842794759826,0.9285714285714286,0.5216400911161732
09-02-480-30-10-03-10-15-05,26,1001,957,44,425,401,532,13.337474120082815,10.014117647058823,11.996240601503759,0.9435294117647058,0.5559038662486938
09-02-480-30-10-03-10-15-05,27,913,871,42,436,411,435,12.994318181818182,9.708715596330276,11.751724137931035,0.9426605504587156,0.49942594718714123
09-02-480-30-10-03-10-15-05,28,982,926,56,428,410,498,13.111229946524064,9.953271028037383,11.757028112449799,0.9579439252336449,0.5377969762419006
09-02-480-30-10-03-10-15-05,29,920,873,47,425,393,448,12.680272108843537,10.042352941176471,11.412946428571429,0.9247058823529412,0.5131729667812142
09-02-480-30-10-03-10-15-05,30,909,866,43,426,400,440,12.790857142857142,9.915492957746478,11.36590909090909,0.9389671361502347,0.5080831408775982
12-02-480-30-10-03-10-15-05,1,982,929,53,565,479,364,11.936238044633368,9.96283185840708,10.662087912087912,0.8477876106194691,0.39181916038751347
12-02-480-30-10-03-10-15-05,2,948,909,39,575,485,334,11.846905537459284,9.87304347826087,10.550898203592814,0.8434782608695652,0.36743674367436746
12-02-480-30-10-03-10-15-05,3,846,821,25,561,420,260,11.111644657863145,10.094474153297682,9.78076923076923,0.7486631016042781,0.3166869671132765
12-02-480-30-10-03-10-15-05,4,912,869,43,561,469,308,11.928490351872872,10.010695187165775,10.49025974025974,0.8360071301247772,0.35443037974683544
12-02-480-30-10-03-10-15-05,5,983,949,34,566,464,383,12.072840790842871,9.962897526501767,10.911227154046998,0.8197879858657244,0.4035827186512118
12-02-480-30-10-03-10-15-05,6,989,951,38,559,476,392,12.101765316718588,10.110912343470483,10.954081632653061,0.851520572450805,0.41219768664563616
12-02-480-30-10-03-10-15-05,7,971,939,32,571,469,368,11.896950578338592,9.912434325744309,10.744565217391305,0.8213660245183888,0.3919062832800852
12-02-480-30-10-03-10-15-05,8,881,842,39,575,397,267,11.101873536299765,9.81913043478261,10.228464419475655,0.6904347826086956,0.3171021377672209
12-02-480-30-10-03-10-15-05,9,1020,977,43,563,489,414,12.216380182002021,10.078152753108348,11.031400966183575,0.8685612788632326,0.42374616171954965
12-02-480-30-10-03-10-15-05,10,935,906,29,559,466,347,11.647058823529411,10.075134168157424,10.328530259365994,0.8336314847942755,0.3830022075055188
12-02-480-30-10-03-10-15-05,11,931,891,40,563,451,328,11.858250276854928,10.02841918294849,10.878048780487806,0.8010657193605684,0.3681257014590348
12-02-480-30-10-03-10-15-05,12,948,914,34,554,463,360,12.011879049676025,10.222021660649819,10.930555555555555,0.8357400722021661,0.3938730853391685
12-02-480-30-10-03-10-15-05,13,908,872,36,570,394,302,11.23076923076923,9.943859649122807,10.350993377483444,0.6912280701754386,0.3463302752293578
12-02-480-30-10-03-10-15-05,14,965,930,35,564,470,366,11.57643312101911,10.044326241134751,10.245901639344263,0.8333333333333334,0.3935483870967742
12-02-480-30-10-03-10-15-05,15,977,934,43,556,462,378,12.274841437632135,10.100719424460431,11.285714285714286,0.8309352517985612,0.40471092077087795
12-02-480-30-10-03-10-15-05,16,990,940,50,561,499,379,12.071428571428571,10.110516934046347,10.899736147757256,0.8894830659536542,0.4031914893617021
12-02-480-30-10-03-10-15-05,17,967,922,45,574,448,348,11.67558886509636,9.848432055749129,10.652298850574713,0.7804878048780488,0.3774403470715835
12-02-480-30-10-03-10-15-05,18,1027,990,37,567,480,423,12.434131736526947,9.947089947089948,11.252955082742316,0.8465608465608465,0.42727272727272725
12-02-480-30-10-03-10-15-05,19,970,919,51,575,467,344,11.721804511278195,9.833043478260869,10.505813953488373,0.8121739130434783,0.37431991294885747
12-02-480-30-10-03-10-15-05,20,974,942,32,572,415,370,11.4916142557652,9.828671328671328,10.64054054054054,0.7255244755244755,0.39278131634819535
12-02-480-30-10-03-10-15-05,21,983,925,58,567,447,358,11.783351120597652,9.975308641975309,11.089385474860336,0.7883597883597884,0.387027027027027
12-02-480-30-10-03-10-15-05,22,951,899,52,560,449,339,11.587266739846322,10.096428571428572,10.315634218289086,0.8017857142857143,0.3770856507230256
12-02-480-30-10-03-10-15-05,23,978,944,34,561,477,383,12.05857740585774,10.07843137254902,10.848563968668408,0.8502673796791443,0.4057203389830508
12-02-480-30-10-03-10-15-05,24,955,918,37,580,467,338,11.472043010752689,9.708620689655172,10.307692307692308,0.8051724137931034,0.3681917211328976
12-02-480-30-10-03-10-15-05,25,867,842,25,564,424,278,11.35480093676815,9.97517730496454,10.492805755395683,0.75177304964539,0.33016627078384797
12-02-480-30-10-03-10-15-05,26,976,930,46,573,436,357,11.670912951167729,9.87085514834206,10.792717086834735,0.7609075043630017,0.38387096774193546
12-02-480-30-10-03-10-15-05,27,977,936,41,569,497,367,12.082278481012658,9.954305799648505,10.722070844686648,0.8734622144112478,0.3920940170940171
12-02-480-30-10-03-10-15-05,28,1036,988,48,567,491,421,12.435,10.0,11.339667458432304,0.8659611992945326,0.42611336032388664
12-02-480-30-10-03-10-15-05,29,978,945,33,574,502,371,12.102403343782655,9.839721254355402,10.959568733153638,0.8745644599303136,0.3925925925925926
12-02-480-30-10-03-10-15-05,30,998,957,41,563,479,394,12.333333333333334,10.081705150976909,11.045685279187817,0.8507992895204263,0.4117032392894462
15-02-480-30-10-03-10-15-05,1,978,949,29,696,413,253,10.267634854771785,10.119252873563218,9.992094861660078,0.5933908045977011,0.2665964172813488
15-02-480-30-10-03-10-15-05,2,1021,979,42,698,421,281,10.496981891348089,10.137535816618911,9.661921708185053,0.6031518624641834,0.2870275791624106
15-02-480-30-10-03-10-15-05,3,1023,976,47,706,452,270,10.939455095862765,9.998583569405099,10.107407407407408,0.6402266288951841,0.2766393442622951
15-02-480-30-10-03-10-15-05,4,944,911,33,708,385,203,10.400647948164147,10.01129943502825,9.645320197044335,0.5437853107344632,0.22283205268935236
15-02-480-30-10-03-10-15-05,5,948,919,29,715,404,204,10.17558886509636,9.874125874125873,9.142156862745098,0.5650349650349651,0.2219804134929271
15-02-480-30-10-03-10-15-05,6,1023,984,39,700,402,284,10.514514514514515,10.057142857142857,9.669014084507042,0.5742857142857143,0.2886178861788618
15-02-480-30-10-03-10-15-05,7,990,967,23,703,450,264,10.370672097759675,9.92460881934566,9.488636363636363,0.6401137980085349,0.2730093071354705
15-02-480-30-10-03-10-15-05,8,919,883,36,698,332,185,10.083518930957684,10.120343839541547,9.605405405405405,0.47564469914040114,0.20951302378255945
15-02-480-30-10-03-10-15-05,9,899,856,43,707,307,149,9.00459242250287,9.867043847241867,8.986577181208053,0.43422913719943423,0.17406542056074767
15-02-480-30-10-03-10-15-05,10,920,883,37,710,285,173,9.198218262806236,9.947887323943663,9.358381502890174,0.4014084507042254,0.19592298980747452
15-02-480-30-10-03-10-15-05,11,942,902,40,705,303,197,9.304252998909487,9.954609929078014,9.939086294416244,0.4297872340425532,0.21840354767184036
15-02-480-30-10-03-10-15-05,12,948,917,31,706,343,211,9.410944206008583,9.956090651558073,9.104265402843602,0.48583569405099153,0.2300981461286805
15-02-480-30-10-03-10-15-05,13,943,906,37,707,358,199,9.867535287730728,10.03111739745403,9.422110552763819,0.5063649222065064,0.2196467991169978
15-02-480-30-10-03-10-15-05,14,995,953,42,710,496,243,11.159090909090908,9.95774647887324,9.868312757201647,0.6985915492957746,0.25498426023084997
15-02-480-30-10-03-10-15-05,15,959,922,37,708,407,214,10.221985058697973,10.0,9.214953271028037,0.5748587570621468,0.23210412147505424
15-02-480-30-10-03-10-15-05,16,965,934,31,706,394,228,10.303477344573235,10.002832861189802,9.697368421052632,0.5580736543909348,0.24411134903640258
15-02-480-30-10-03-10-15-05,17,1001,974,27,698,432,276,10.713852376137513,10.03295128939828,10.18840579710145,0.6189111747851003,0.28336755646817247
15-02-480-30-10-03-10-15-05,18,929,898,31,703,345,195,9.76998904709748,10.088193456614508,9.338461538461539,0.4907539118065434,0.21714922048997773
15-02-480-30-10-03-10-15-05,19,948,925,23,721,291,204,9.127659574468085,9.769764216366157,9.637254901960784,0.40360610263522884,0.22054054054054054
15-02-480-30-10-03-10-15-05,20,888,841,47,701,259,140,9.157710280373832,9.97432239657632,9.007142857142858,0.369472182596291,0.16646848989298454
15-02-480-30-10-03-10-15-05,21,986,930,56,706,372,224,9.895238095238096,9.992917847025495,9.401785714285714,0.5269121813031161,0.24086021505376345
15-02-480-30-10-03-10-15-05,22,948,894,54,714,334,180,9.402640264026402,9.820728291316527,9.144444444444444,0.4677871148459384,0.20134228187919462
15-02-480-30-10-03-10-15-05,23,950,905,45,715,352,190,9.480434782608695,9.746853146853146,9.257894736842106,0.49230769230769234,0.20994475138121546
15-02-480-30-10-03-10-15-05,24,896,868,28,709,317,159,9.44960362400906,9.959097320169253,9.415094339622641,0.44710860366713684,0.18317972350230416
15-02-480-30-10-03-10-15-05,25,1024,988,36,715,459,273,10.495513459621137,9.857342657342658,9.63003663003663,0.641958041958042,0.27631578947368424
15-02-480-30-10-03-10-15-05,26,940,901,39,691,403,210,9.83406113537118,10.018813314037626,9.185714285714285,0.5832127351664255,0.23307436182019978
15-02-480-30-10-03-10-15-05,27,953,905,48,721,320,184,9.501086956521739,9.804438280166435,9.358695652173912,0.44382801664355065,0.20331491712707184
15-02-480-30-10-03-10-15-05,28,945,909,36,709,378,200,9.978354978354979,10.001410437235544,9.34,0.5331452750352609,0.22002200220022003
15-02-480-30-10-03-10-15-05,29,923,889,34,716,319,173,9.53650442477876,9.885474860335195,9.208092485549132,0.44553072625698326,0.19460067491563554
15-02-480-30-10-03-10-15-05,30,932,891,41,703,350,188,9.736203090507725,10.012802275960171,8.888297872340425,0.49786628733997157,0.21099887766554434
18-02-480-30-10-03-10-15-05,1,1003,969,34,838,302,131,8.480243161094226,9.926014319809068,7.702290076335878,0.360381861575179,0.13519091847265222
18-02-480-30-10-03-10-15-05,2,996,950,46,832,167,118,7.363636363636363,10.048076923076923,8.423728813559322,0.20072115384615385,0.12421052631578948
18-02-480-30-10-03-10-15-05,3,944,920,24,832,101,88,6.644989339019189,10.021634615384615,7.909090909090909,0.12139423076923077,0.09565217391304348
18-02-480-30-10-03-10-15-05,4,944,908,36,812,175,96,6.282937365010799,10.030788177339902,7.510416666666667,0.21551724137931033,0.10572687224669604
18-02-480-30-10-03-10-15-05,5,967,926,41,837,177,89,7.483050847457627,9.986857825567503,7.584269662921348,0.2114695340501792,0.09611231101511879
18-02-480-30-10-03-10-15-05,6,965,923,42,836,150,87,6.458023379383635,10.070574162679426,7.022988505747127,0.17942583732057416,0.09425785482123511
18-02-480-30-10-03-10-15-05,7,862,830,32,791,45,39,4.5129716981132075,10.034134007585335,6.717948717948718,0.056890012642225034,0.046987951807228916
18-02-480-30-10-03-10-15-05,8,1006,967,39,839,265,128,8.472081218274111,10.01430274135876,7.953125,0.31585220500595945,0.13236814891416754
18-02-480-30-10-03-10-15-05,9,929,903,26,849,118,54,5.8914223669923995,9.87514723203769,7.351851851851852,0.13898704358068315,0.059800664451827246
18-02-480-30-10-03-10-15-05,10,920,890,30,845,70,45,5.856828193832599,10.008284023668638,6.533333333333333,0.08284023668639054,0.05056179775280899
18-02-480-30-10-03-10-15-05,11,1002,977,25,862,185,115,7.766834170854271,9.863109048723897,7.834782608695652,0.21461716937354988,0.11770726714431934
18-02-480-30-10-03-10-15-05,12,957,915,42,849,119,66,6.52411575562701,9.99057714958775,7.5,0.14016489988221437,0.07213114754098361
18-02-480-30-10-03-10-15-05,13,1041,1000,41,855,259,145,8.340864440078585,9.95906432748538,8.53103448275862,0.30292397660818715,0.145
18-02-480-30-10-03-10-15-05,14,925,895,30,842,78,53,5.889375684556407,9.958432304038006,7.509433962264151,0.09263657957244656,0.05921787709497207
18-02-480-30-10-03-10-15-05,15,932,915,17,848,59,67,5.789699570815451,9.883254716981131,6.582089552238806,0.0695754716981132,0.073224043715847
18-02-480-30-10-03-10-15-05,16,990,954,36,846,174,108,7.493827160493828,10.022458628841608,8.462962962962964,0.20567375886524822,0.11320754716981132
18-02-480-30-10-03-10-15-05,17,936,918,18,837,65,81,6.57051282051282,10.090800477897252,6.777777777777778,0.07765830346475508,0.08823529411764706
18-02-480-30-10-03-10-15-05,18,1061,1020,41,854,330,166,8.763005780346822,9.86182669789227,8.44578313253012,0.3864168618266979,0.1627450980392157
18-02-480-30-10-03-10-15-05,19,925,903,22,845,107,58,4.888165038002172,9.824852071005918,7.0344827586206895,0.12662721893491125,0.06423034330011074
18-02-480-30-10-03-10-15-05,20,984,945,39,846,183,99,7.862928348909658,9.94917257683215,7.97979797979798,0.21631205673758866,0.10476190476190476
18-02-480-30-10-03-10-15-05,21,961,915,46,811,176,104,6.155412647374062,10.025893958076448,8.596153846153847,0.21701602959309493,0.11366120218579236
18-02-480-30-10-03-10-15-05,22,915,888,27,840,70,48,6.161147902869757,10.004761904761905,7.0625,0.08333333333333333,0.05405405405405406
18-02-480-30-10-03-10-15-05,23,992,965,27,846,243,119,8.052899287894201,9.981087470449173,8.294117647058824,0.2872340425531915,0.12331606217616581
18-02-480-30-10-03-10-15-05,24,937,904,33,854,57,50,5.561822125813449,9.93208430913349,7.28,0.06674473067915691,0.05530973451327434
18-02-480-30-10-03-10-15-05,25,1005,968,37,843,290,125,8.690669371196755,9.98576512455516,8.792,0.34400948991696323,0.12913223140495866
18-02-480-30-10-03-10-15-05,26,937,890,47,847,45,43,4.416299559471366,9.84297520661157,7.1395348837209305,0.053128689492325853,0.048314606741573035
18-02-480-30-10-03-10-15-05,27,973,943,30,830,234,113,7.646201873048907,9.912048192771085,8.725663716814159,0.2819277108433735,0.11983032873807
18-02-480-30-10-03-10-15-05,28,899,864,35,824,44,40,4.633786848072562,9.807038834951456,6.975,0.05339805825242718,0.046296296296296294
18-02-480-30-10-03-10-15-05,29,923,885,38,841,40,44,4.775193798449612,9.913198573127229,6.0227272727272725,0.04756242568370987,0.04971751412429379
18-02-480-30-10-03-10-15-05,30,890,864,26,820,50,44,5.998866213151928,10.263414634146342,6.454545454545454,0.06097560975609756,0.05092592592592592
21-02-480-30-10-03-10-15-05,1,949,910,39,888,38,22,3.611170784103115,10.033783783783784,7.409090909090909,0.04279279279279279,0.024175824175824177
21-02-480-30-10-03-10-15-05,2,888,857,31,854,0,3,0.9783599088838268,9.947306791569087,1.6666666666666667,0.0,0.003500583430571762
21-02-480-30-10-03-10-15-05,3,929,904,25,897,2,7,1.8702702702702703,10.059085841694538,3.5714285714285716,0.002229654403567447,0.007743362831858407
21-02-480-30-10-03-10-15-05,4,1004,987,17,948,56,39,4.127490039840637,9.974683544303797,7.641025641025641,0.05907172995780591,0.03951367781155015
21-02-480-30-10-03-10-15-05,5,972,948,24,916,67,32,4.1269349845201235,9.936681222707424,7.40625,0.07314410480349345,0.03375527426160337
21-02-480-30-10-03-10-15-05,6,932,908,24,905,0,3,1.7061356297093648,9.83646408839779,2.3333333333333335,0.0,0.003303964757709251
21-02-480-30-10-03-10-15-05,7,992,949,43,941,14,8,2.796907216494845,9.890541976620616,3.375,0.01487778958554729,0.008429926238145416
21-02-480-30-10-03-10-15-05,8,968,938,30,926,1,12,2.2283628779979145,10.014038876889849,4.833333333333333,0.0010799136069114472,0.01279317697228145
21-02-480-30-10-03-10-15-05,9,1056,1037,19,968,138,69,6.0293560606060606,10.133264462809917,7.869565217391305,0.14256198347107438,0.0665380906460945
21-02-480-30-10-03-10-15-05,10,1015,992,23,970,34,22,3.943731490621915,9.936082474226804,7.363636363636363,0.03505154639175258,0.02217741935483871
21-02-480-30-10-03-10-15-05,11,958,946,12,921,11,25,2.9112734864300625,9.73615635179153,5.08,0.011943539630836048,0.026427061310782242
21-02-480-30-10-03-10-15-05,12,979,955,24,916,60,39,3.5174180327868854,10.025109170305678,7.0,0.06550218340611354,0.040837696335078534
21-02-480-30-10-03-10-15-05,13,989,963,26,932,25,31,3.991869918699187,10.026824034334764,5.064516129032258,0.02682403433476395,0.032191069574247146
21-02-480-30-10-03-10-15-05,14,965,945,20,932,2,13,3.0756476683937826,10.054721030042918,4.846153846153846,0.002145922746781116,0.013756613756613757
21-02-480-30-10-03-10-15-05,15,941,918,23,907,0,11,1.70926517571885,9.914002205071665,2.8181818181818183,0.0,0.011982570806100218
21-02-480-30-10-03-10-15-05,16,944,901,43,888,9,13,2.4067245119305856,10.039414414414415,5.846153846153846,0.010135135135135136,0.014428412874583796
21-02-480-30-10-03-10-15-05,17,1007,983,24,951,28,32,3.156374501992032,10.005257623554154,6.8125,0.029442691903259727,0.03255340793489318
21-02-480-30-10-03-10-15-05,18,932,914,18,896,18,18,2.912017167381974,10.0,6.944444444444445,0.020089285714285716,0.019693654266958426
21-02-480-30-10-03-10-15-05,19,925,905,20,895,6,10,1.7935135135135136,10.098324022346368,4.4,0.0067039106145251395,0.011049723756906077
21-02-480-30-10-03-10-15-05,20,1021,958,63,944,25,14,2.7150153217568946,9.94385593220339,5.142857142857143,0.026483050847457626,0.014613778705636743
21-02-480-30-10-03-10-15-05,21,936,901,35,892,0,9,2.4642082429501087,9.847533632286995,4.555555555555555,0.0,0.009988901220865706
21-02-480-30-10-03-10-15-05,22,997,982,15,939,47,43,4.864593781344032,9.963791267305645,6.767441860465116,0.05005324813631523,0.04378818737270876
21-02-480-30-10-03-10-15-05,23,965,937,28,918,17,19,3.5636743215031315,10.089324618736384,5.421052631578948,0.018518518518518517,0.020277481323372464
21-02-480-30-10-03-10-15-05,24,968,942,26,930,2,12,2.6843198338525442,10.058064516129033,2.8333333333333335,0.002150537634408602,0.012738853503184714
21-02-480-30-10-03-10-15-05,25,994,968,26,950,2,18,3.3670374115267947,9.974736842105264,5.611111111111111,0.002105263157894737,0.01859504132231405
21-02-480-30-10-03-10-15-05,26,991,955,36,931,8,24,2.7366803278688523,9.973147153598282,5.833333333333333,0.008592910848549946,0.025130890052356022
21-02-480-30-10-03-10-15-05,27,942,927,15,903,18,24,2.738853503184713,10.029900332225914,5.541666666666667,0.019933554817275746,0.025889967637540454
21-02-480-30-10-03-10-15-05,28,1036,1005,31,962,63,43,4.766081871345029,9.971933471933472,7.534883720930233,0.06548856548856549,0.042786069651741296
21-02-480-30-10-03-10-15-05,29,938,913,25,910,0,3,1.9014989293361884,10.010989010989011,4.0,0.0,0.0032858707557502738
21-02-480-30-10-03-10-15-05,30,920,895,25,888,6,7,1.9115720524017468,9.93918918918919,3.4285714285714284,0.006756756756756757,0.00782122905027933
24-02-480-30-10-03-10-15-05,1,869,850,19,847,0,3,0.906789413118527,9.840613931523022,5.333333333333333,0.0,0.0035294117647058825
24-02-480-30-10-03-10-15-05,2,951,934,17,933,0,1,0.6330178759200841,10.170418006430868,2.0,0.0,0.0010706638115631692
24-02-480-30-10-03-10-15-05,3,995,977,18,975,0,2,1.5969849246231156,9.984615384615385,3.5,0.0,0.0020470829068577278
24-02-480-30-10-03-10-15-05,4,879,863,16,861,0,2,0.5221843003412969,9.937282229965156,4.0,0.0,0.002317497103128621
24-02-480-30-10-03-10-15-05,5,941,928,13,927,0,1,0.46971307120085015,9.862998921251348,1.0,0.0,0.0010775862068965517
24-02-480-30-10-03-10-15-05,6,986,967,19,957,0,10,1.279918864097363,9.799373040752352,3.5,0.0,0.010341261633919338
24-02-480-30-10-03-10-15-05,7,893,882,11,882,0,0,0.45240761478163494,9.890022675736962,,0.0,0.0
24-02-480-30-10-03-10-15-05,8,975,955,20,953,0,2,0.9261538461538461,9.888772298006296,4.0,0.0,0.0020942408376963353
24-02-480-30-10-03-10-15-05,9,959,911,48,907,0,4,0.6598930481283423,9.835722160970231,3.75,0.0,0.0043907793633369925
24-02-480-30-10-03-10-15-05,10,965,945,20,941,0,4,0.9347150259067357,9.875664187035069,4.25,0.0,0.004232804232804233
24-02-480-30-10-03-10-15-05,11,976,964,12,944,18,20,1.8002049180327868,9.977754237288135,5.2,0.019067796610169493,0.02074688796680498
24-02-480-30-10-03-10-15-05,12,957,946,11,941,0,5,1.3657262277951934,9.934112646121148,3.2,0.0,0.005285412262156448
24-02-480-30-10-03-10-15-05,13,946,935,11,932,0,3,0.8329809725158562,9.986051502145923,2.6666666666666665,0.0,0.0032085561497326204
24-02-480-30-10-03-10-15-05,14,892,873,19,873,0,0,0.26121076233183854,10.026345933562428,,0.0,0.0
24-02-480-30-10-03-10-15-05,15,1001,958,43,943,8,15,1.6883910386965377,10.06150583244963,5.066666666666666,0.008483563096500531,0.015657620041753653
24-02-480-30-10-03-10-15-05,16,1014,990,24,988,0,2,0.9644970414201184,9.856275303643725,3.0,0.0,0.00202020202020202
24-02-480-30-10-03-10-15-05,17,1000,978,22,973,0,5,1.08,9.882836587872559,3.2,0.0,0.005112474437627812
24-02-480-30-10-03-10-15-05,18,970,948,22,945,0,3,0.6185567010309279,9.96084656084656,1.3333333333333333,0.0,0.0031645569620253164
24-02-480-30-10-03-10-15-05,19,918,901,17,899,0,2,0.5904139433551199,10.140155728587319,1.5,0.0,0.0022197558268590455
24-02-480-30-10-03-10-15-05,20,990,974,16,965,3,9,2.06969696969697,10.067357512953368,4.0,0.0031088082901554403,0.009240246406570842
24-02-480-30-10-03-10-15-05,21,948,930,18,928,0,2,0.7668776371308017,9.931034482758621,4.0,0.0,0.002150537634408602
24-02-480-30-10-03-10-15-05,22,955,932,23,929,0,3,0.5319371727748691,9.720129171151775,5.0,0.0,0.003218884120171674
24-02-480-30-10-03-10-15-05,23,928,907,21,905,0,2,0.5334051724137931,10.03756906077348,4.0,0.0,0.002205071664829107
24-02-480-30-10-03-10-15-05,24,978,951,27,950,0,1,0.521025641025641,9.996842105263157,1.0,0.0,0.0010515247108307045
24-02-480-30-10-03-10-15-05,25,974,955,19,952,0,3,0.6776180698151951,9.960084033613445,2.3333333333333335,0.0,0.0031413612565445027
24-02-480-30-10-03-10-15-05,26,1043,1018,25,1012,0,6,1.1410748560460653,9.787549407114625,3.8333333333333335,0.0,0.005893909626719057
24-02-480-30-10-03-10-15-05,27,957,934,23,928,2,6,1.3772204806687565,9.954741379310345,5.0,0.0021551724137931034,0.006423982869379015
24-02-480-30-10-03-10-15-05,28,884,864,20,863,0,1,0.3993212669683258,10.098493626882966,3.0,0.0,0.0011574074074074073
24-02-480-30-10-03-10-15-05,29,994,972,22,964,2,8,1.0543259557344065,9.978215767634854,5.625,0.002074688796680498,0.00823045267489712
24-02-480-30-10-03-10-15-05,30,874,856,18,856,0,0,0.30778032036613273,9.853971962616823,,0.0,0.0
27-02-480-30-10-03-10-15-05,1,941,922,19,922,0,0,0.2784272051009564,10.001084598698482,,0.0,0.0
27-02-480-30-10-03-10-15-05,2,1027,1002,25,1000,0,2,0.6212268743914313,9.985,1.5,0.0,0.001996007984031936
27-02-480-30-10-03-10-15-05,3,952,924,28,923,0,1,0.42691903259726605,9.843986998916577,3.0,0.0,0.0010822510822510823
27-02-480-30-10-03-10-15-05,4,1010,979,31,979,0,0,0.5,9.884576098059243,,0.0,0.0
27-02-480-30-10-03-10-15-05,5,950,938,12,936,1,2,0.4031578947368421,10.037393162393162,4.5,0.0010683760683760685,0.0021321961620469083
27-02-480-30-10-03-10-15-05,6,1066,1046,20,1042,0,4,0.7964352720450282,10.119001919385797,3.0,0.0,0.0038240917782026767
27-02-480-30-10-03-10-15-05,7,954,938,16,938,0,0,0.14675052410901468,10.018123667377399,,0.0,0.0
27-02-480-30-10-03-10-15-05,8,1030,1011,19,1008,0,3,0.8155339805825242,10.008928571428571,2.0,0.0,0.002967359050445104
27-02-480-30-10-03-10-15-05,9,980,968,12,968,0,0,0.18571428571428572,9.792355371900827,,0.0,0.0
27-02-480-30-10-03-10-15-05,10,935,920,15,920,0,0,0.10481283422459893,9.839130434782609,,0.0,0.0
27-02-480-30-10-03-10-15-05,11,988,967,21,967,0,0,0.20242914979757085,9.968976215098243,,0.0,0.0
27-02-480-30-10-03-10-15-05,12,936,910,26,909,0,1,0.30235042735042733,9.873487348734873,4.0,0.0,0.001098901098901099
27-02-480-30-10-03-10-15-05,13,915,900,15,900,0,0,0.29180327868852457,10.133333333333333,,0.0,0.0
27-02-480-30-10-03-10-15-05,14,902,877,25,877,0,0,0.1984478935698448,9.955530216647663,,0.0,0.0
27-02-480-30-10-03-10-15-05,15,985,966,19,966,0,0,0.23857868020304568,10.093167701863354,,0.0,0.0
27-02-480-30-10-03-10-15-05,16,1075,1045,30,1035,29,10,2.1417910447761193,10.094685990338164,6.9,0.028019323671497585,0.009569377990430622
27-02-480-30-10-03-10-15-05,17,957,944,13,941,0,3,0.5841170323928945,9.946865037194474,2.6666666666666665,0.0,0.0031779661016949155
27-02-480-30-10-03-10-15-05,18,927,905,22,905,0,0,0.104638619201726,9.808839779005526,,0.0,0.0
27-02-480-30-10-03-10-15-05,19,939,918,21,918,0,0,0.3759318423855165,10.040305010893245,,0.0,0.0
27-02-480-30-10-03-10-15-05,20,967,943,24,941,0,2,0.7300930713547052,9.888416578108396,2.5,0.0,0.0021208907741251328
27-02-480-30-10-03-10-15-05,21,960,943,17,943,0,0,0.35208333333333336,9.881230116648993,,0.0,0.0
27-02-480-30-10-03-10-15-05,22,952,926,26,926,0,0,0.25945378151260506,10.071274298056155,,0.0,0.0
27-02-480-30-10-03-10-15-05,23,952,939,13,939,0,0,0.5955882352941176,9.928647497337593,,0.0,0.0
27-02-480-30-10-03-10-15-05,24,964,935,29,935,0,0,0.4896049896049896,10.071657754010696,,0.0,0.0
27-02-480-30-10-03-10-15-05,25,996,983,13,982,0,1,0.5371485943775101,9.89409368635438,2.0,0.0,0.001017293997965412
27-02-480-30-10-03-10-15-05,26,972,958,14,957,0,1,0.6604938271604939,9.869383490073146,3.0,0.0,0.0010438413361169101
27-02-480-30-10-03-10-15-05,27,903,878,25,878,0,0,0.22812846068660023,10.08883826879271,,0.0,0.0
27-02-480-30-10-03-10-15-05,28,945,929,16,929,0,0,0.3682539682539683,9.939720129171151,,0.0,0.0
27-02-480-30-10-03-10-15-05,29,1031,1004,27,996,0,8,1.2376333656644034,9.970883534136545,5.0,0.0,0.00796812749003984
27-02-480-30-10-03-10-15-05,30,976,949,27,947,0,2,0.2827868852459016,9.970432946145724,3.0,0.0,0.002107481559536354
30-02-480-30-10-03-10-15-05,1,912,893,19,893,0,0,0.021929824561403508,9.912653975363941,,0.0,0.0
30-02-480-30-10-03-10-15-05,2,946,922,24,922,0,0,0.046511627906976744,10.09761388286334,,0.0,0.0
30-02-480-30-10-03-10-15-05,3,1058,1029,29,1028,0,1,0.40926275992438566,10.114785992217898,1.0,0.0,0.0009718172983479105
30-02-480-30-10-03-10-15-05,4,953,928,25,928,0,0,0.04197271773347324,10.038793103448276,,0.0,0.0
30-02-480-30-10-03-10-15-05,5,919,898,21,898,0,0,0.05223068552774755,9.973273942093542,,0.0,0.0
30-02-480-30-10-03-10-15-05,6,1020,1003,17,1002,0,1,0.1892156862745098,9.934131736526947,1.0,0.0,0.0009970089730807576
30-02-480-30-10-03-10-15-05,7,1004,991,13,991,0,0,0.3286852589641434,10.159434914228052,,0.0,0.0
30-02-480-30-10-03-10-15-05,8,927,899,28,899,0,0,0.039913700107874865,9.862068965517242,,0.0,0.0
30-02-480-30-10-03-10-15-05,9,867,850,17,849,0,1,0.1903114186851211,9.84452296819788,3.0,0.0,0.001176470588235294
30-02-480-30-10-03-10-15-05,10,1079,1064,15,1063,0,1,0.303985171455051,9.847601128880527,1.0,0.0,0.0009398496240601503
30-02-480-30-10-03-10-15-05,11,931,913,18,913,0,0,0.16326530612244897,9.978094194961665,,0.0,0.0
30-02-480-30-10-03-10-15-05,12,960,932,28,931,0,1,0.03958333333333333,9.961331901181525,1.0,0.0,0.001072961373390558
30-02-480-30-10-03-10-15-05,13,938,923,15,923,0,0,0.07036247334754797,9.926327193932828,,0.0,0.0
30-02-480-30-10-03-10-15-05,14,900,878,22,878,0,0,0.10555555555555556,10.250569476082005,,0.0,0.0
30-02-480-30-10-03-10-15-05,15,997,977,20,977,0,0,0.11634904714142427,9.94575230296827,,0.0,0.0
30-02-480-30-10-03-10-15-05,16,978,956,22,954,0,2,0.2893660531697341,10.00524109014675,2.0,0.0,0.0020920502092050207
30-02-480-30-10-03-10-15-05,17,1010,986,24,985,0,1,0.15544554455445544,9.889340101522842,1.0,0.0,0.0010141987829614604
30-02-480-30-10-03-10-15-05,18,951,930,21,930,0,0,0.05783385909568875,10.044086021505377,,0.0,0.0
30-02-480-30-10-03-10-15-05,19,1018,1004,14,1004,0,0,0.26620825147347743,10.04382470119522,,0.0,0.0
30-02-480-30-10-03-10-15-05,20,958,940,18,940,0,0,0.24321503131524008,10.093617021276597,,0.0,0.0
30-02-480-30-10-03-10-15-05,21,1048,1026,22,1026,0,0,0.09732824427480916,9.95224171539961,,0.0,0.0
30-02-480-30-10-03-10-15-05,22,930,909,21,909,0,0,0.0989247311827957,10.082508250825082,,0.0,0.0
30-02-480-30-10-03-10-15-05,23,966,944,22,944,0,0,0.10559006211180125,10.101694915254237,,0.0,0.0
30-02-480-30-10-03-10-15-05,24,944,924,20,923,0,1,0.0836864406779661,10.187432286023835,2.0,0.0,0.0010822510822510823
30-02-480-30-10-03-10-15-05,25,944,928,16,928,0,0,0.034957627118644065,9.976293103448276,,0.0,0.0
30-02-480-30-10-03-10-15-05,26,913,896,17,896,0,0,0.06681270536692223,10.116071428571429,,0.0,0.0
30-02-480-30-10-03-10-15-05,27,964,954,10,953,0,1,0.3039419087136929,10.21511017838405,3.0,0.0,0.0010482180293501049
30-02-480-30-10-03-10-15-05,28,886,855,31,855,0,0,0.0655367231638418,10.057309941520467,,0.0,0.0
30-02-480-30-10-03-10-15-05,29,997,969,28,968,0,1,0.15045135406218657,10.014462809917354,1.0,0.0,0.0010319917440660474
30-02-480-30-10-03-10-15-05,30,901,878,23,878,0,0,0.013318534961154272,9.865603644646924,,0.0,0.0
